Southern Adventure
An Interactive Fiction by Sylvan Zheng
Release 1 / Serial number 201029 / Inform 7 build 6M62 (I6/v6.34 lib 6/12N) SD

Hospital Room (in the bed)
You are in what appears to be a hospital room. The walls are bare save for a bulletin board. 

A door across the room is slightly ajar. Outside, voices drift softly back and forth.

A cracked window lets in a feeble amount of light.

You see a phone, wallet, and keys on the table across the room.

You can also see a tattered novel here.

>climb the window
The window is shut: you'd break the glass.

>open the window
You open the cracked window.

>climb through the window
grassy slope
A cracked window lets in a feeble amount of light

* * *

Southern Adventure
An Interactive Fiction by Sylvan Zheng
Release 1 / Serial number 201029 / Inform 7 build 6M62 (I6/v6.34 lib 6/12N) SD

Hospital Room (in the bed)
You are in what appears to be a hospital room. The walls are bare save for a bulletin board. 

A door across the room is slightly ajar. Outside, voices drift softly back and forth.

A cracked window lets in a feeble amount of light.

You see a phone, wallet, and keys on the table across the room.

You can also see a tattered novel here.

>e
You would have to get out of the bed first.

>get out
You get out of the bed.

Hospital Room
You are in what appears to be a hospital room. The walls are bare save for a bulletin board.

A door across the room is slightly ajar. Outside, voices drift softly back and forth.

A cracked window lets in a feeble amount of light.

You see a phone, wallet, and keys on the table across the room.

You can also see a bulletin board and a tattered novel here.

>x
What do you want to examine?

>look
Hospital Room
You are in what appears to be a hospital room. The walls are bare save for a bulletin board.

A door across the room is slightly ajar. Outside, voices drift softly back and forth.

A cracked window lets in a feeble amount of light.

You see a phone, wallet, and keys on the table across the room.

You can also see a bulletin board and a tattered novel here.

>look
Hospital Room
You are in what appears to be a hospital room. The walls are bare save for a bulletin board.

A door across the room is slightly ajar. Outside, voices drift softly back and forth.

A cracked window lets in a feeble amount of light.

You see a phone, wallet, and keys on the table across the room.

You can also see a bulletin board and a tattered novel here.

>remove iv drip
You yank out the IV drip from your arm.

>e
The hallway is full of hospital staff, bustling to and fro. Eventually, one notices your hospital gown and ushers you back into your room.

Hospital Room (in the bed)
You are in what appears to be a hospital room. The walls are bare save for a bulletin board.

A door across the room is slightly ajar. Outside, voices drift softly back and forth.

A cracked window lets in a feeble amount of light.

You see a phone, wallet, and keys on the table across the room.

You can also see a bulletin board and a tattered novel here.

>remove iv drip
You yank out the IV drip from your arm.

>get out
You get out of the bed.

Hospital Room
You are in what appears to be a hospital room. The walls are bare save for a bulletin board.

A door across the room is slightly ajar. Outside, voices drift softly back and forth.

A cracked window lets in a feeble amount of light.

You see a phone, wallet, and keys on the table across the room.

You can also see a bulletin board and a tattered novel here.

>open windwo
You can't see any such thing.

>open window
You open the cracked window.

* * *

Southern Adventure
An Interactive Fiction by Sylvan Zheng
Release 1 / Serial number 201029 / Inform 7 build 6M62 (I6/v6.34 lib 6/12N) SD

Hospital Room (in the bed)
You are in what appears to be a hospital room. The walls are bare save for a bulletin board. 

A door across the room is slightly ajar. Outside, voices drift softly back and forth.

A cracked window lets in a feeble amount of light.

You see a phone, wallet, and keys on the table across the room.

You can also see a tattered novel here.

>get out
You get out of the bed.

Hospital Room
You are in what appears to be a hospital room. The walls are bare save for a bulletin board.

A door across the room is slightly ajar. Outside, voices drift softly back and forth.

A cracked window lets in a feeble amount of light.

You see a phone, wallet, and keys on the table across the room.

You can also see a tattered novel here.

>remove iv drip
You wrap your fingers around the needle and yank out the IV drip. A small trail of blood runs down your arm.

>e
Hospital Room (in the bed)
You are in what appears to be a hospital room. The walls are bare save for a bulletin board.

The door across the room has been tightly locked.

A cracked window lets in a feeble amount of light.

You see a phone, wallet, and keys on the table across the room.

You can also see a tattered novel here.

>open door
The door is locked tightly.

You open the hall door.

* * *

>remove iv drip
You wrap your fingers around the needle and yank out the IV drip. A small trail of blood runs down your arm.

>go door
The hallway is full of hospital staff, bustling to and fro. Eventually, one notices your hospital gown and ushers you back into your room.

>x bulletin board
You can't see any such thing.

>x novel
You can't see any such thing.

>i
You are carrying nothing.

* * *

>remove iv drip
You wrap your fingers around the needle and yank out the IV drip. A small trail of blood runs down your arm.

>go e
There's not much to see in that direction.

>go door
The hallway is full of hospital staff, bustling to and fro. Eventually, one notices your hospital gown and ushers you back into your room.

Hospital Room
You are in what appears to be a hospital room. The walls are bare save for a bulletin board.

A door across the room is slightly ajar. Outside, voices drift softly back and forth.

A cracked window lets in a feeble amount of light.

You are lying in a bed.

You see a phone on the table across the room.

You can also see a wallet, keys, a bulletin board and a tattered novel here.

>ge tout
That's not a verb I recognise.

>get out
But you aren't in anything at the moment.

* * *

>remove iv drip
You wrap your fingers around the needle and yank out the IV drip. A small trail of blood runs down your arm.

>open window
You open the cracked window.

>s
*** Run-time problem P44: Attempt to remove a door from play.

* * *

>remove iv drip
You wrap your fingers around the needle and yank out the IV drip. A small trail of blood runs down your arm.

>out
But you aren't in anything at the moment.

>door
That's not a verb I recognise.

>e
Hospital Room (in the bed)
You are in what appears to be a hospital room. The walls are bare save for a bulletin board.

A door across the room is slightly ajar. Outside, voices drift softly back and forth.

A cracked window lets in a feeble amount of light.

You see a phone, wallet, and keys on the table across the room.

You can also see a tattered novel here.

>x bulletin board
A page pinned to the board suggests that Mr. Roaldmann's sepsis complication has reached a critical stage. 
Another page notes that he has been found wandering the hospital premises and is to be put under tighter security. It's difficult to read the small print, so you quickly give up.

>e
You would have to get out of the bed first.

>get out
You get out of the bed.

Hospital Room
You are in what appears to be a hospital room. The walls are bare save for a bulletin board.

A door across the room is slightly ajar. Outside, voices drift softly back and forth.

A cracked window lets in a feeble amount of light.

You see a phone, wallet, and keys on the table across the room.

You can also see a tattered novel here.

>e
You can't move very far while attached to the IV drip.

>remove iv drip
You wrap your fingers around the needle and yank out the IV drip. A small trail of blood runs down your arm.

>e
Hospital Room (in the bed)
You are in what appears to be a hospital room. The walls are bare save for a bulletin board.

A door across the room is slightly ajar. Outside, voices drift softly back and forth.

A cracked window lets in a feeble amount of light.

You see a phone, wallet, and keys on the table across the room.

You can also see a tattered novel here.

* * *

Southern Adventure
An Interactive Fiction by Sylvan Zheng
Release 1 / Serial number 201029 / Inform 7 build 6M62 (I6/v6.34 lib 6/12N) SD

Hospital Room (in the bed)
You are in what appears to be a hospital room. The walls are bare save for a bulletin board. 

A door across the room is slightly ajar. Outside, voices drift softly back and forth.

A cracked window lets in a feeble amount of light.

You see a phone, wallet, and keys on the table across the room.

You can also see a tattered novel here.

>get ut
You can't see any such thing.

>get out
You get out of the bed.

Hospital Room
You are in what appears to be a hospital room. The walls are bare save for a bulletin board.

A door across the room is slightly ajar. Outside, voices drift softly back and forth.

A cracked window lets in a feeble amount of light.

You see a phone, wallet, and keys on the table across the room.

You can also see a bulletin board and a tattered novel here.

>remove iv drip
You yank out the IV drip from your arm.

>open window
You open the cracked window.

>s
Grassy Slope
The meadow is peaceful and quiet. The sun, directly ahead, warms your face. In the distance to the west you can make out a small shack.

A deep and raging river runs through the meadow to the south. Further, a dark forest looms.

* * *

Southern Adventure
An Interactive Fiction by Sylvan Zheng
Release 1 / Serial number 201029 / Inform 7 build 6M62 (I6/v6.34 lib 6/12N) SD

Hospital Room (in the bed)
You are in what appears to be a hospital room. The walls are bare save for a bulletin board. 

A door across the room is slightly ajar. Outside, voices drift softly back and forth.

A cracked window lets in a feeble amount of light.

You see a phone, wallet, and keys on the table across the room.

You can also see a tattered novel here.

>go door
The hallway is full of hospital staff, bustling to and fro. Eventually, one notices your hospital gown and ushers you back into your room.

>x iv drip
It's a bag of fluid raised above you. A small tube runs from the bag into your arm.

>remove iv drip
You yank out the IV drip from your arm.

* * *

Southern Adventure
An Interactive Fiction by Sylvan Zheng
Release 1 / Serial number 201029 / Inform 7 build 6M62 (I6/v6.34 lib 6/12N) SD

Hospital Room (in the bed)
You are in what appears to be a hospital room. The walls are bare save for a bulletin board. 

A door across the room is slightly ajar. Outside, voices drift softly back and forth.

A cracked window lets in a feeble amount of light.

You see a phone, wallet, and keys on the table across the room.

You can also see a tattered novel here.

>go e
You would have to get out of the bed first.

>go door
You would have to get out of the bed first.

>go w
You would have to get out of the bed first.

>go n
You would have to get out of the bed first.

>go s
The window is shut: you'd break the glass.

>get out of bed
I only understood you as far as wanting to get outside.

>get out of the bed
I only understood you as far as wanting to get outside.

>get out
You get out of the bed.

Hospital Room
You are in what appears to be a hospital room. The walls are bare save for a bulletin board.

A door across the room is slightly ajar. Outside, voices drift softly back and forth.

A cracked window lets in a feeble amount of light.

You are lying in a bed.

You see a phone on the table across the room.

You can also see a wallet, keys, a bulletin board and a tattered novel here.

>go e
There's not much to see in that direction.

>go door
You can't move very far while attached to the IV drip.

>remove iv drip
You yank out the IV drip from your arm.

>go door
The hallway is full of hospital staff, bustling to and fro. Eventually, one notices your hospital gown and ushers you back into your room.

Hallway
A door across the room is slightly ajar. Outside, voices drift softly back and forth.

* * *

>go e
You would have to get out of the bed first.

>s
The window is shut.

>get out
You get out of the bed.

Hospital Room
You are in what appears to be a hospital room. The walls are bare save for a bulletin board.

A door across the room is slightly ajar. Outside, voices drift softly back and forth.

A cracked window lets in a feeble amount of light.

You see a phone, wallet, and keys on the table across the room.

You can also see a bulletin board and a tattered novel here.

* * *

>remove iv drip
You yank out the IV drip from your arm.

>e
Hospital Room (in the bed)
You are in what appears to be a hospital room. The walls are bare save for a bulletin board.

A door across the room is slightly ajar. Outside, voices drift softly back and forth.

A cracked window lets in a feeble amount of light.

You see a phone, wallet, and keys on the table across the room.

You can also see a bulletin board and a tattered novel here.

>go to door
You can't see any such thing.

>go door
You would have to get out of the bed first.

* * *

Southern Adventure
An Interactive Fiction by Sylvan Zheng
Release 1 / Serial number 201029 / Inform 7 build 6M62 (I6/v6.34 lib 6/12N) SD

Hospital Room (in the bed)
You are in what appears to be a hospital room. The walls are bare save for a bulletin board. 

A door across the room is slightly ajar. Outside, voices drift softly back and forth.

A cracked window lets in a feeble amount of light.

You see a phone, wallet, and keys on the table across the room.

You can also see a tattered novel here.

>go east
The hallway is full of hospital staff, bustling to and fro. Eventually, one notices your hospital gown and ushers you back into your room.

>go east
The hallway is full of hospital staff, bustling to and fro. Eventually, one notices your hospital gown and ushers you back into your room.

>go west
The window is shut: you'd break the glass.

>open window
You open the cracked window.

>go north
You can't go that way.

>go through window
Grassy Slope
The meadow outside the hopsital is peaceful and quiet. The prickle of the grass beneath your feet is strangely titillating.

A cracked window lets in a feeble amount of light.

A shallow river runs through the meadow.

>x river
You see nothing special about the shallow river.

>cross river
(first opening the shallow river)

forest
A shallow river runs through the meadow.

* * *

>go east
The hallway is full of hospital staff, bustling to and fro. Eventually, one notices your hospital gown and ushers you back into your room.

>go west
You can't go that way.

>x window
You can't see any such thing.

>x a window
You can't see any such thing.

* * *

>go east
The hallway is full of hospital staff, bustling to and fro. Eventually, one notices your hospital gown and ushers you back into your room.

>x window
You can't see any such thing.

>go west
You can't go that way.

>go
You'll have to say which compass direction to go in.

>x window
You can't see any such thing.

>x
What do you want to examine?

>x room
You can't see any such thing.

>x hospital room
You can't see any such thing.

* * *

Southern Adventure
An Interactive Fiction by Sylvan Zheng
Release 1 / Serial number 201029 / Inform 7 build 6M62 (I6/v6.34 lib 6/12N) SD

Hospital Room (in the bed)
You are in what appears to be a hospital room. The walls are bare save for a bulletin board. 

A door across the room is slightly ajar. Outside, voices drift softly back and forth.

A cracked window lets in a feeble amount of light.

You see a phone, wallet, and keys on the table across the room.

You can also see a tattered novel here.

>go n
You would have to get out of the bed first.

>go e
The hallway is full of hospital staff, bustling to and fro. Eventually, one notices your hospital gown and ushers you back into your room.

* * *

>go n
You would have to get out of the bed first.

>remove iv drip
You yank out the IV drip from your arm.

You remove the IV drip

* * *

Southern Adventure
An Interactive Fiction by Sylvan Zheng
Release 1 / Serial number 201029 / Inform 7 build 6M62 (I6/v6.34 lib 6/12N) SD

Hospital Room (in the bed)
You are in what appears to be a hospital room. The walls are bare save for a bulletin board. 

A door across the room is slightly ajar. Outside, voices drift softly back and forth.

A cracked window lets in a feeble amount of light.

You see a phone, wallet, and keys on the table across the room.

You can also see a tattered novel here.

>go s
The window is shut: you'd break the glass.

>go n
You would have to get out of the bed first.

>get out of bed
I only understood you as far as wanting to get outside.

>get out
You get out of the bed.

Hospital Room
You are in what appears to be a hospital room. The walls are bare save for a bulletin board.

A door across the room is slightly ajar. Outside, voices drift softly back and forth.

A cracked window lets in a feeble amount of light.

There is an IV drip next to you.

You are lying in a bed.

You see a phone on the table across the room.

You can also see a wallet, keys, a bulletin board and a tattered novel here.

>go n
You can't go that way.

>go w
You can't go that way.

>go e
The hallway is full of hospital staff, bustling to and fro. Eventually, one notices your hospital gown and ushers you back into your room.

* * *

>go s
The window is shut: you'd break the glass.

>open window
You open the cracked window.

>go s
Grassy Slope
The meadow is peaceful and quiet. The sun, directly ahead, warms your face. In the distance to the west you can make out a small shack.

A cracked window lets in a feeble amount of light.

A deep and raging river runs through the meadow to the south. Further, a dark forest looms.

>go w
You meander west along the riverbank for what seems like hours. Above you the sun barely moves in the sky, its rays continuing to illuminate your surroundings with a golden glow.

Riverbank
You see a hut in the distance

A rickety bridge extends toward the opposite bank. It sways gently into the wind.

An unkempt woman sits on the porch of the hut, fanning herself slowly with a folded newspaper.

>give
What do you want to give a woman?

>wallet
You can't see any such thing.

>go e
There's not much to see in that direction.

>go n
You can't go that way.

* * *

Southern Adventure
An Interactive Fiction by Sylvan Zheng
Release 1 / Serial number 201029 / Inform 7 build 6M62 (I6/v6.34 lib 6/12N) SD

Hospital Room (in the bed)
You are in what appears to be a hospital room. The walls are bare save for a bulletin board. 

A door across the room is slightly ajar. Outside, voices drift softly back and forth.

A cracked window lets in a feeble amount of light.

You see a phone, wallet, and keys on the table across the room.

You can also see a tattered novel here.

>go south
The window is shut: you'd break the glass.

>open window
You open the cracked window.

>go south
Grassy Slope
The meadow is peaceful and quiet. The sun, directly ahead, warms your face. In the distance to the west you can make out a small shack.

A cracked window lets in a feeble amount of light.

A deep and raging river runs through the meadow to the south. Further, a dark forest looms.

>go west
Riverbank
lorem ipsum

An unkempt woman sits on the porch of the hut, fanning herself slowly with a folded newspaper.

>go in
hut

* * *

Southern Adventure
An Interactive Fiction by Sylvan Zheng
Release 1 / Serial number 201029 / Inform 7 build 6M62 (I6/v6.34 lib 6/12N) SD

Hospital Room (in the bed)
You are in what appears to be a hospital room. The walls are bare save for a bulletin board. 

A door across the room is slightly ajar. Outside, voices drift softly back and forth.

A cracked window lets in a feeble amount of light.

You see a phone, wallet, and keys on the table across the room.

You can also see a tattered novel here.

>go through door
Hallway
The hallway is full of hospital staff, bustling to and fro. Eventually, one notices your hospital gown.

A door across the room is slightly ajar. You can hear voices drift softly back and forth.

* * *

Southern Adventure
An Interactive Fiction by Sylvan Zheng
Release 1 / Serial number 201029 / Inform 7 build 6M62 (I6/v6.34 lib 6/12N) SD

Hospital Room (in the bed)
You are in what appears to be a hospital room. The walls are bare save for a bulletin board. 

A door across the room is slightly ajar. Outside, voices drift softly back and forth.

A cracked window lets in a feeble amount of light.

You see a phone, wallet, and keys on the table across the room.

You can also see a tattered novel here.

>go through the door
The hallway is full of hospital staff, bustling to and fro. Eventually, one notices your hospital gown and ushers you back into your room.

>x
What do you want to examine?

>x door
You see nothing special about the hall door.

>x iv drip
It's a bag of fluid raised above you. A small tube runs from the bag into your arm.

* * *

Southern Adventure
An Interactive Fiction by Sylvan Zheng
Release 1 / Serial number 201029 / Inform 7 build 6M62 (I6/v6.34 lib 6/12N) SD

Hospital Room (in the bed)
You are in what appears to be a hospital room. The walls are bare save for a bulletin board. 

A door across the room is slightly ajar. Outside, voices drift softly back and forth.

A cracked window lets in a feeble amount of light.

You see a phone, wallet, and keys on the table across the room.

You can also see a tattered novel here.

>go through window
The window is shut: you'd break the glass.

>open window
You open the cracked window.

>go through window
Grassy Slope
The meadow outside the hopsital is peaceful and quiet. The prickle of the grass beneath your feet is strangely titillating.

A cracked window lets in a feeble amount of light.

* * *

Southern Adventure
An Interactive Fiction by Sylvan Zheng
Release 1 / Serial number 201029 / Inform 7 build 6M62 (I6/v6.34 lib 6/12N) SD

Hospital Room (in the bed)
You are in what appears to be a hospital room. The walls are bare save for a bulletin board. 

A door across the room is slightly ajar. Outside, voices drift softly back and forth.

A cracked window lets in a feeble amount of light.

You see a phone, wallet, and keys on the table across the room.

You can also see a tattered novel here.

>go to door
You can't see any such thing.

* * *

Southern Adventure
An Interactive Fiction by Sylvan Zheng
Release 1 / Serial number 201029 / Inform 7 build 6M62 (I6/v6.34 lib 6/12N) SD

Hospital Room (in the bed)
You are in what appears to be a hospital room. The walls are bare save for a bulletin board. 

A door across the room is slightly ajar. Outside, voices drift softly back and forth.

A cracked window lets in a feeble amount of light.

You see a phone, wallet, and keys on the table across the room.

You can also see a tattered novel here.

>leave room
I only understood you as far as wanting to leave.

>go to door
You can't see any such thing.

>go door
The hallway is full of hospital staff, bustling to and fro. Eventually, one notices your hospital gown and ushers you back into your room.

* * *

Southern Adventure
An Interactive Fiction by Sylvan Zheng
Release 1 / Serial number 201029 / Inform 7 build 6M62 (I6/v6.34 lib 6/12N) SD

Hospital Room (in the bed)
You are in what appears to be a hospital room. The walls are bare save for a bulletin board. 

A door across the room is slightly ajar. Outside, voices drift softly back and forth.

A cracked window lets in a feeble amount of light.

You see a phone, wallet, and keys on the table across the room.

You can also see a tattered novel here.

>look through window
You can't see any such thing.

* * *

Southern Adventure
An Interactive Fiction by Sylvan Zheng
Release 1 / Serial number 201029 / Inform 7 build 6M62 (I6/v6.34 lib 6/12N) SD

Hospital Room (in the bed)
You are in what appears to be a hospital room. The walls are bare save for a bulletin board. 

A door across the room is slightly ajar. Outside, voices drift softly back and forth.

A cracked window lets in a feeble amount of light.

You see a phone, wallet, and keys on the table across the room.

You can also see a tattered novel here.

>open door
You open the hall door.

>go through door
hallway
A door across the room is slightly ajar. You can hear voices drift softly back and forth

* * *

Southern Adventure
An Interactive Fiction by Sylvan Zheng
Release 1 / Serial number 201029 / Inform 7 build 6M62 (I6/v6.34 lib 6/12N) SD

Hospital Room (in the bed)
You are in what appears to be a hospital room. The walls are bare save for a bulletin board. 

A door across the room is slightly ajar. Outside, voices drift softly back and forth.

A cracked window lets in a feeble amount of light.

You see a phone, wallet, and keys on the table across the room.

You can also see a tattered novel here.

>open the window
You open the cracked window.

>go through the window
Grassy Slope
The grassy slope is quiet. The prickle of the grass beneath your feet is strangely titillating.

A cracked window lets in a feeble amount of light

* * *

Southern Adventure
An Interactive Fiction by Sylvan Zheng
Release 1 / Serial number 201029 / Inform 7 build 6M62 (I6/v6.34 lib 6/12N) SD

Hospital Room (in the bed)
You are in what appears to be a hospital room. The walls are bare save for a bulletin board. 

A door across the room is slightly ajar. Outside, voices drift softly back and forth.

A cracked window lets in a feeble amount of light.

You see a phone, wallet, and keys on the table across the room.

You can also see a tattered novel here.

>open window
You open the cracked window.

>go outside
You can't go that way.

>go out
You can't go that way.

>go south
Grassy Slope
The meadow is peaceful and quiet. The sun, directly ahead, warms your face. In the distance to the west you can make out a small shack.

A cracked window lets in a feeble amount of light.

A deep and raging river runs through the meadow to the south. Further, a dark forest looms.

>go west
You meander west along the riverbank for what seems like hours. Above you the sun barely moves in the sky, its rays continuing to illuminate your surroundings with a golden glow.

Riverbank
You see a hut in the distance

A rickety bridge extends from the riverbank toward the opposite bank. It sways gently into the wind.

An unkempt woman sits on the porch of the hut, fanning herself slowly with a folded newspaper.

>go south
You gingerly take a few steps. The planks creak menacingly.
On the fourth step the bridge plank cracks beneath your feet! You plummet into the river.

Hospital Room
You are in what appears to be a hopsital room.

A cracked window lets in a feeble amount of light.

A door across the room is slightly ajar. Outside voices drift softly back and forth.

There is an IV drip next to you.

You are lying in a bed.

You see a phone on the table across the room.

You can also see a wallet, keys, a sheaf of papers and a tattered novel here.

* * *

>open window
You open the cracked window.

>go s
You would have to get out of the bed first.

* * *

>go south
Grassy Slope
The meadow is peaceful and quiet. The sun, directly ahead, warms your face. In the distance to the west you can make out a small shack.

A cracked window lets in a feeble amount of light.

A deep and raging river runs through the meadow to the south. Further, a dark forest looms.

>cross river
The river is far too wide and dangerous to cross on foot. Best find another way.

* * *

>go south
Grassy Slope
The meadow is peaceful and quiet. The sun, directly ahead, warms your face. In the distance to the west you can make out a small shack.

A cracked window lets in a feeble amount of light.

A deep and raging river runs through the meadow to the south. Further, a dark forest looms.

>go east
There's not much to see in that direction.

>go west
Shack
You are outside a small shack. A sunbleached sign reads "FERRY SERVICE"

* * *

>go south
Grassy Slope
The meadow is peaceful and quiet. The sun, directly ahead, warms your face. In the distance to the west you can make out a small shack.

A cracked window lets in a feeble amount of light.

A deep and raging river runs through the meadow to the south. Further, a dark forest looms.

>go south
The river is far too wide and dangerous to cross on foot. Best to find another way.

>go west
Shack
You are outside a small shack. A sunbleached sign reads "FERRY SERVICE".

A woman sits on the porch, fanning herself slowly with a folded newspaper

>ask her
(for Sharon)
(Sharon first taking Sharon)
Sharon has better things to do.

>talk to her
To start a conversation, try to ASK Sharon ABOUT something.

* * *

>go west
You meander west along the riverbank for what seems like hours. Above you the sun barely moves in the sky, its rays continuing to illuminate your surroundings with a golden glow.

Riverbank
You see a hut in the distance

A rickety bridge extends from the riverbank toward the opposite bank. It sways gently into the wind.

An unkempt woman sits on the porch of the hut, fanning herself slowly with a folded newspaper.

>go into hut
You can't see any such thing.

* * *

>go west
You meander west along the riverbank for what seems like hours. Above you the sun barely moves in the sky, its rays continuing to illuminate your surroundings with a golden glow.

Riverbank
You see a hut in the distance

A rickety bridge extends from the riverbank toward the opposite bank. It sways gently into the wind.

An unkempt woman sits on the porch of the hut, fanning herself slowly with a folded newspaper.

>talk to sharon
That's not a verb I recognise.

>tell sharon about ferry
She charges a few dollars for passage across the river

>tell sharon
I didn't understand that sentence.

* * *

>go south
Grassy Slope
The meadow is peaceful and quiet. The sun, directly ahead, warms your face. In the distance to the west you can make out a small shack.

A cracked window lets in a feeble amount of light.

A deep and raging river runs through the meadow to the south. Further, a dark forest looms.

>w
You meander west along the riverbank for what seems like hours. Above you the sun barely moves in the sky, its rays continuing to illuminate your surroundings with a golden glow.

Riverbank
You see a hut in the distance

An unkempt woman sits on the porch of the hut, fanning herself slowly with a folded newspaper.

>go in
The woman angrily brandishes a large pole at you, but you narrowly dodge her attack and slip inside.

Hut

>go out
Riverbank
You see a hut in the distance

An unkempt woman sits on the porch of the hut, fanning herself slowly with a folded newspaper.

>give the woman
(a woman)
(first taking a woman)
I don't suppose a woman would care for that.

>give the woman a wallet
You can't see any such thing.

>give the woman thje wallet
You can't see any such thing.

>give the woman the wallet
You can't see any such thing.

>take wallet
You can't see any such thing.

>i
You are carrying nothing.

>go south
You can't go that way.

* * *

>go south
Grassy Slope
The meadow is peaceful and quiet. The sun, directly ahead, warms your face. In the distance to the west you can make out a small shack.

A cracked window lets in a feeble amount of light.

A deep and raging river runs through the meadow to the south. Further, a dark forest looms.

>x river
You see nothing special about the shallow river.

>cross river
forest
A shallow river divides the meadow from a dark forest.

* * *

>open window
You open the cracked window.

>go through window
Grassy Slope
The meadow is peaceful and quiet. The sun, directly ahead, warms your face. In the distance to the west you can make out a small shack.

A cracked window lets in a feeble amount of light.

A deep and raging river runs through the meadow to the south. Further, a dark forest looms.

>cross river
(first opening the shallow river)

forest
A shallow river divides the meadow from a dark forest.

* * *

>go through window
Grassy Slope
The meadow is peaceful and quiet. The sun, directly ahead, warms your face. In the distance to the west you can make out a small shack.

A cracked window lets in a feeble amount of light.

A deep and raging river runs through the meadow to the south. Further, a dark forest looms.

>go west
Riverbank
lorem ipsum

An unkempt woman sits on the porch of the hut, fanning herself slowly with a folded newspaper.

>ask sharon
(for Sharon)
(Sharon first taking Sharon)
Sharon has better things to do.

>ask sharon about something
She is willing to take travelers across the river for a small fee

>ask sharon about the river
She is willing to take travelers across the river for a small fee

>talk to sharon
To start a conversation, try to ASK Sharon ABOUT something.

>ask sharon about the river
She is willing to take travelers across the river for a small fee

* * *

>go west
Riverbank
lorem ipsum

An unkempt woman sits on the porch of the hut, fanning herself slowly with a folded newspaper.

>x hu
You can't see any such thing.

>x hut
You can't see any such thing.

>go into the hut
You can't see any such thing.

* * *

Southern Adventure
An Interactive Fiction by Sylvan Zheng
Release 1 / Serial number 201029 / Inform 7 build 6M62 (I6/v6.34 lib 6/12N) SD

Hospital Room (in the bed)
You are in what appears to be a hospital room. The walls are bare save for a bulletin board. 

A door across the room is slightly ajar. Outside, voices drift softly back and forth.

A cracked window lets in a feeble amount of light.

You see a phone, wallet, and keys on the table across the room.

You can also see a tattered novel here.

>pet novel
That's not a verb I recognise.

>read novel
It's a dog eared copy of Don Quixote, by Miguel Cervantes.

* * *

Southern Adventure
An Interactive Fiction by Sylvan Zheng
Release 1 / Serial number 201029 / Inform 7 build 6M62 (I6/v6.34 lib 6/12N) SD

Hospital Room (in the bed)
You are in what appears to be a hospital room. The walls are bare save for a bulletin board. 

A door across the room is slightly ajar. Outside, voices drift softly back and forth.

A cracked window lets in a feeble amount of light.

You see a phone, wallet, and keys on the table across the room.

You can also see a tattered novel here.

>pet the bed
That's not a verb I recognise.

>bet the phone
That's not a verb I recognise.

>pet the phone
That's not a verb I recognise.

>take wallet
Taken.

>open window
You open the cracked window.

* * *

>go s
Grassy Slope
The meadow is peaceful and quiet. The sun, directly ahead, warms your face. In the distance to the west you can make out a small shack.

A cracked window lets in a feeble amount of light.

A deep and raging river runs through the meadow to the south. Further, a dark forest looms.

>go w
You meander west along the riverbank for what seems like hours. Above you the sun barely moves in the sky, its rays continuing to illuminate your surroundings with a golden glow.

Riverbank
You see a hut in the distance

A rickety bridge extends from toward the opposite bank. It sways gently into the wind.

An unkempt woman sits on the porch of the hut, fanning herself slowly with a folded newspaper.

>go s
You gingerly take a few steps. The planks creak menacingly.
On the fourth step the bridge plank cracks beneath your feet! You plummet into the river.

Hospital Room
You are in what appears to be a hopsital room.

A cracked window lets in a feeble amount of light.

A door across the room is slightly ajar. Outside voices drift softly back and forth.

There is an IV drip next to you.

You are lying in a bed.

You see a phone on the table across the room.

You can also see keys, a sheaf of papers and a tattered novel here.

>go w
You can't go that way.

>go s
Grassy Slope
The meadow is peaceful and quiet. The sun, directly ahead, warms your face. In the distance to the west you can make out a small shack.

A cracked window lets in a feeble amount of light.

A deep and raging river runs through the meadow to the south. Further, a dark forest looms.

* * *

>go w
You meander west along the riverbank for what seems like hours. Above you the sun barely moves in the sky, its rays continuing to illuminate your surroundings with a golden glow.

Riverbank
You see a hut in the distance

A rickety bridge extends from toward the opposite bank. It sways gently into the wind.

An unkempt woman sits on the porch of the hut, fanning herself slowly with a folded newspaper.

>give
(a woman the wallet)
The woman pockets the money and guides you across the bridge. As you cross she warns you against stepping on several of the bridge planks, which have led more than one traveler to their deaths. She laughs gutturally. Below you the river rages loudly.

dark forest
The forest hums with the chatter of animal life. The trees cast deep shadows across the undergrowth. Further in the distance you see a dim light, emnating an orange electric glow.

A rickety bridge extends from toward the opposite bank. It sways gently into the wind.

>n
The forest extends deeply in all directions

>go w
The forest extends deeply in all directions

>go e
The forest extends deeply in all directions

>go s
After pushing aside numerous branches and swatting away flies, you enter a clearing. In the clearing is a railroad station.

railroad station
The railroad station is impeccably architected, with a large archway entrance and beautiful iron grated windows

A cat with a beautiful dark coat of fur purrs gently, asleep.

>pet cat
That's not a verb I recognise.

>petting
That's not a verb I recognise.

>pet the cat
That's not a verb I recognise.

* * *

Southern Adventure
An Interactive Fiction by Sylvan Zheng
Release 1 / Serial number 201029 / Inform 7 build 6M62 (I6/v6.34 lib 6/12N) SD

Hospital Room (in the bed)
You are in what appears to be a hospital room. The walls are bare save for a bulletin board. 

A door across the room is slightly ajar. Outside, voices drift softly back and forth.

A cracked window lets in a feeble amount of light.

You see a phone, wallet, and keys on the table across the room.

You can also see a tattered novel here.

>pet wallet
That wouldn't make very much sense

>read wallet
Nothing is written on the wallet.

>take all
phone: Taken.
wallet: Taken.
keys: Taken.
bulletin board: Taken.
tattered novel: Taken.

>open window
You open the cracked window.

>s
Grassy Slope
The meadow is peaceful and quiet. The sun, directly ahead, warms your face. In the distance to the west you can make out a small shack.

A cracked window lets in a feeble amount of light.

A deep and raging river runs through the meadow to the south. Further, a dark forest looms.

>w
You meander west along the riverbank for what seems like hours. Above you the sun barely moves in the sky, its rays continuing to illuminate your surroundings with a golden glow.

Riverbank
You see a hut in the distance

A rickety bridge extends toward the opposite bank. It sways gently into the wind.

An unkempt woman sits on the porch of the hut, fanning herself slowly with a folded newspaper.

>give
What do you want to give a woman?

>wallet
(to a woman)
The woman pockets the money and guides you across the bridge. As you cross she warns you against stepping on several of the bridge planks, which have led more than one traveler to their deaths. She laughs gutturally. Below you the river rages loudly.

dark forest
The forest hums with the chatter of animal life. The trees cast deep shadows across the undergrowth. Further to the south you see a faint orange electric glow.

A rickety bridge extends toward the opposite bank. It sways gently into the wind.

>s
After pushing aside numerous branches and swatting away flies, you enter a clearing. In the clearing is a railroad station.

railroad station
The railroad station is impeccably architected, with a large archway entrance and beautiful iron grated windows.

A cat with a beautiful dark coat of fur purrs gently, curled up on the tiled floor.

You can also see a ticket counter here.

>enter train
You can't see any such thing.

I beg your pardon?

>s
traincar
You board the train. The conductor walks by, and instead of checking for your ticket merely gives you a friendly smile. You sit down in an empty compartment, which isn't particularly difficult to find. Unperturbed, you settle into your seat as the train clunks into motion.

Looking out the window you see the forest give way to valleys and mountains, and then open plains with the occasional solitary cow. The sun, still yellow in the sky gives clouds a luminance that makes them like appear like marble. The shadow of the railroad car stretches longer and longer toward the horizon, yet the sun remains fixed in the sky, at that golden angle just before dusk. From your seat on the train the country appears both vast and intimate.

You can also see a train door here.

>s
You trek for a half mile along the train tracks, the yellow sun continuing to illuminate the great grassy plain around you with a golden aura.

It would be wise to wait until the train is stopped before attempting to get off!

>read novel
You read: "It seems to me," responded don Quixote, "that you aren't well-versed in adventures-they are giants; and if you're afraid, get away from here and start praying while I go into fierce and unequal battle with them." 
 And saying this, he spurred his horse Rocinante without heeding what his squire Sancho was shouting to him, that he was attacking windmills and not giants. But he was so certain they were giants that he paid no attention to his squire Sancho's shouts, nor did he see what they were, even though he was very close. Rather, he went on shouting: "Do not flee, cowards and vile creatures, for it's just one knight attacking you!"

A grinding screech jolts you out of Cervantes" intricate world. Looking out the window it seems the train has stopped. The conductor has reappeared and has opened the train door.

>go s
You trek for a half mile along the train tracks, the yellow sun continuing to illuminate the great grassy plain around you with a golden aura.

town square
You are in a sleepy town square. You can see a saloon to the west and a shuttered general store to the east.

A shady looking figure lurks in the corner.

You can also see a train door here.

>go e
The general store is closed, which seems odd for this time of day. Perhaps that's just the way they do things out in the countryside.

>go w
saloon
An empty saloon.

With no customers, the bartender is absentmindedly drying glasses behind the bar.

>talk to bartender
To start a conversation, try to ASK the bartender ABOUT something.

>ask the bartender about taxis
Unfortunately the taxi drivers are out on strike today. You might have seen them out in the square. If you're not in a rush, it might be a good idea to stay in town for the night. Would you care for a drink?

>yes
The bartender pours you a Sazerac, the deep orange of the rye whiskey casting a faint glow on the dusty table. Certainly you haven't had one of these in a while - the hospital's bar service was rather lacking due to its nonexistence.

>go w
You can't go that way.

>go e
There's not much to see in that direction.

* * *

>go n
You can't go that way.

>go s
You can't go that way.

* * *

Southern Adventure
An Interactive Fiction by Sylvan Zheng
Release 1 / Serial number 201029 / Inform 7 build 6M62 (I6/v6.34 lib 6/12N) SD

Hospital Room (in the bed)
You are in what appears to be a hospital room. The walls are bare save for a bulletin board. 

A door across the room is slightly ajar. Outside, voices drift softly back and forth.

A cracked window lets in a feeble amount of light.

You see a phone, wallet, and keys on the table across the room.

You can also see a tattered novel here.

>read book
You can't see any such thing.

>read novel
shitzu

* * *

Southern Adventure
An Interactive Fiction by Sylvan Zheng
Release 1 / Serial number 201029 / Inform 7 build 6M62 (I6/v6.34 lib 6/12N) SD

Hospital Room (in the bed)
You are in what appears to be a hospital room. The walls are bare save for a bulletin board. 

A door across the room is slightly ajar. Outside, voices drift softly back and forth.

A cracked window lets in a feeble amount of light.

You see a phone, wallet, and keys on the table across the room.

You can also see a tattered novel here.

>read novel
You flip to a random page
You read: "It seems to me," responded don Quixote, "that you aren't well-versed in adventures-they are giants; and if you're afraid, get away from here and start praying while I go into fierce and unequal battle with them." And saying this, he spurred his horse Rocinante without heeding what his squire Sancho was shouting to him, that he was attacking windmills and not giants. But he was so certain they were giants that he paid no attention to his squire Sancho's shouts, nor did he see what they were, even though he was very close. Rather, he went on shouting: "Do not flee, cowards and vile creatures, for it's just one knight attacking you!"

You feel a slight headache. You put the book down.

>read book
You can't see any such thing.

* * *

>take novel
Taken.

>read novel
It's a dog eared copy of Don Quixote, by Miguel Cervantes.

>x novel
It's a dog eared copy of Don Quixote, by Miguel Cervantes.

>showme novel
tattered novel - thing
location: carried by yourself in Hospital Room
singular-named, improper-named; unlit, inedible, portable, handled
list grouping key: none
printed name: "tattered novel"
printed plural name: none
indefinite article: none
description: "It's a dog eared copy of Don Quixote, by Miguel Cervantes."
initial appearance: none

>pet novel
That's not a verb I recognise.

* * *

Southern Adventure
An Interactive Fiction by Sylvan Zheng
Release 1 / Serial number 201029 / Inform 7 build 6M62 (I6/v6.34 lib 6/12N) SD

Hospital Room (in the bed)
You are in what appears to be a hospital room. The walls are bare save for a bulletin board. 

A door across the room is slightly ajar. Outside, voices drift softly back and forth.

A cracked window lets in a feeble amount of light.

You see a phone, wallet, and keys on the table across the room.

You can also see a tattered novel here.

>read the novel
It's a dog eared copy of Don Quixote, by Miguel Cervantes.

>read novel
It's a dog eared copy of Don Quixote, by Miguel Cervantes.

* * *

>read the novel
It's a dog eared copy of Don Quixote, by Miguel Cervantes.

>x novel
It's a dog eared copy of Don Quixote, by Miguel Cervantes.

>take wallet
Taken.

>go w
You can't go that way.

>open window
You open the cracked window.

* * *

>w
You meander west along the riverbank for what seems like hours. Above you the sun barely moves in the sky, its rays continuing to illuminate your surroundings with a golden glow.

Riverbank
You see a hut in the distance

A rickety bridge extends toward the opposite bank. It sways gently into the wind.

An unkempt woman sits on the porch of the hut, fanning herself slowly with a folded newspaper.

>give
(a woman the wallet)
The woman pockets the money and guides you across the bridge. As you cross she warns you against stepping on several of the bridge planks, which have led more than one traveler to their deaths. She laughs gutturally. Below you the river rages loudly.

dark forest
The forest hums with the chatter of animal life. The trees cast deep shadows across the undergrowth. Further to the south you see a faint orange electric glow.

A rickety bridge extends toward the opposite bank. It sways gently into the wind.

>s
After pushing aside numerous branches and swatting away flies, you enter a clearing. In the clearing is a railroad station.

railroad station
The railroad station is impeccably architected, with a large archway entrance and beautiful iron grated windows.

A cat with a beautiful dark coat of fur purrs gently, curled up on the tiled floor.

You can also see a ticket counter here.

>in
You can't go that way.

>x ticket counter
The ticket counter seems deserted. However, there is a train waiting at the platform. Perhaps you could go inside it anyway?

>go int
You can't see any such thing.

>go in
You can't go that way.

* * *

Southern Adventure
An Interactive Fiction by Sylvan Zheng
Release 1 / Serial number 201029 / Inform 7 build 6M62 (I6/v6.34 lib 6/12N) SD

Hospital Room (in the bed)
You are in what appears to be a hospital room. The walls are bare save for a bulletin board. 

A door across the room is slightly ajar. Outside, voices drift softly back and forth.

A cracked window lets in a feeble amount of light.

You see a phone, wallet, and keys on the table across the room.

You can also see a tattered novel here.

>remove iv dri
I only understood you as far as wanting to remove the IV drip.

>remove iv drip
You yank out the IV drip from your arm.

* * *

Southern Adventure
An Interactive Fiction by Sylvan Zheng
Release 1 / Serial number 201029 / Inform 7 build 6M62 (I6/v6.34 lib 6/12N) SD

Hospital Room (in the bed)
You are in what appears to be a hospital room. The walls are bare save for a bulletin board. 

A door across the room is slightly ajar. Outside, voices drift softly back and forth.

A cracked window lets in a feeble amount of light.

You see a phone, wallet, and keys on the table across the room.

You can also see a tattered novel here.

>remove iv drip
You yank out the IV drip from your arm.

* * *

>get out
You get out of the bed.

Hospital Room
You are in what appears to be a hospital room. The walls are bare save for a bulletin board.

A door across the room is slightly ajar. Outside, voices drift softly back and forth.

A cracked window lets in a feeble amount of light.

You see a phone, wallet, and keys on the table across the room.

You can also see a bulletin board and a tattered novel here.

>open window
You open the cracked window.

>s
Grassy Slope
The meadow is peaceful and quiet. The sun, directly ahead, warms your face. In the distance to the west you can make out a small shack.

A deep and raging river runs through the meadow to the south. Further, a dark forest looms.

You can also see a cracked window here.

>open river
You open the river.

* * *

Southern Adventure
An Interactive Fiction by Sylvan Zheng
Release 1 / Serial number 201029 / Inform 7 build 6M62 (I6/v6.34 lib 6/12N) SD

Hospital Room (in the bed)
You are in what appears to be a hospital room. The walls are bare save for a bulletin board. 

A door across the room is slightly ajar. Outside, voices drift softly back and forth.

A cracked window lets in a feeble amount of light.

You see a phone, wallet, and keys on the table across the room.

You can also see a tattered novel here.

>take al
You can't see any such thing.

>take all
phone: Taken.
wallet: Taken.
keys: Taken.
tattered novel: Taken.

>open window
You open the cracked window.

>s
You would have to get out of the bed first.

>get out
You get out of the bed.

Hospital Room
You are in what appears to be a hospital room. The walls are bare save for a bulletin board.

A door across the room is slightly ajar. Outside, voices drift softly back and forth.

A cracked window lets in a feeble amount of light.

>s
You can't move very far while attached to the IV drip.

>remove iv drip
You yank out the IV drip from your arm.

>s
Grassy Slope
The meadow outside the hospital is peaceful and quiet. The sun, directly above, warms your face. 

A deep and raging river runs through to the south. Further, a dark forest looms.

>w
Riverbank
You arrive at a small peninsula in the riverbank. An unkempt woman sits on the porch of a small hut, absentmindedly tapping the ground beside her with a blackened fire poker.

A rickety bridge extends toward the opposite bank. It sways gently into the wind.

The woman's scratching forms a dreamlike rhythm...

>ask woman about bridge
There is no reply.

The woman's scratching forms a dreamlike rhythm...

>ask woman about the bridge
There is no reply.

The woman's scratching forms a dreamlike rhythm...

* * *

Southern Adventure
An Interactive Fiction by Sylvan Zheng
Release 1 / Serial number 201029 / Inform 7 build 6M62 (I6/v6.34 lib 6/12N) SD

Hospital Room (in the bed)
You are in what appears to be a hospital room. The walls are bare save for a bulletin board. 

A door across the room is slightly ajar. Outside, voices drift softly back and forth.

A cracked window lets in a feeble amount of light.

You see a phone, wallet, and keys on the table across the room.

You can also see a tattered novel here.

>take all
keys: Taken.
phone: Taken.
wallet: Taken.
tattered novel: Taken.

>e
You would have to get out of the bed first.

>get out
You get out of the bed.

Hospital Room
You are in what appears to be a hospital room. The walls are bare save for a bulletin board.

A door across the room is slightly ajar. Outside, voices drift softly back and forth.

A cracked window lets in a feeble amount of light.

You can also see a bulletin board here.

>e
You can't move very far while attached to the IV drip.

>remove iv drip
You yank out the IV drip from your arm.

>e
The hallway is full of hospital staff, bustling to and fro. Eventually, one notices your hospital gown and ushers you back into your room, reconnecting the IV and putting you back into bed.

Hospital Room (in the bed)
You are in what appears to be a hospital room. The walls are bare save for a bulletin board.

A door across the room is slightly ajar. Outside, voices drift softly back and forth.

A cracked window lets in a feeble amount of light.

You can also see a bulletin board here.

>remove iv drip
You yank out the IV drip from your arm.

>get out
You get out of the bed.

Hospital Room
You are in what appears to be a hospital room. The walls are bare save for a bulletin board.

A door across the room is slightly ajar. Outside, voices drift softly back and forth.

A cracked window lets in a feeble amount of light.

You can also see a bulletin board here.

>open window
You open the cracked window.

>s
Grassy Slope
The meadow is peaceful and quiet. The sun, directly ahead, warms your face. In the distance to the west you can make out a small hut.

A deep and raging river runs through to the south. Further, a dark forest looms.

>e
You can't go that way.

* * *

>take all
keys: Taken.
phone: Taken.
wallet: Taken.
tattered novel: Taken.

>get out
You get out of the bed.

Hospital Room
You are in what appears to be a hospital room. The walls are bare save for a bulletin board. 

A door across the room is slightly ajar. Outside, voices drift softly back and forth.

A cracked window lets in a feeble amount of light.

>door
That's not a verb I recognise.

>e
You can't move very far while attached to the IV drip.

* * *

>remove iv drip
You wrap your fingers around the needle and yank out the IV drip. A small trail of blood runs down your arm.

>e
Hospital Room (in the bed)
You are in what appears to be a hospital room. The walls are bare save for a bulletin board.

The door across the room has been tightly locked.

A cracked window lets in a feeble amount of light.

>x bulletin board
A page pinned to the board suggests that Mr. Roaldmann's sepsis complication has reached a critical stage. 
Another page notes that he has been found wandering the hospital premises and is to be put under tighter security. It's difficult to read the small print, so you quickly give up.

>restart
Are you sure you want to restart?

>yes
elsur
An Interactive Fiction
Release 1 / Serial number 201028 / Inform 7 build 6M62 (I6/v6.34 lib 6/12N) SD

Hospital Room (in the bed)
You are in what appears to be a hospital room. The walls are bare save for a bulletin board.

A door across the room is slightly ajar. Outside, voices drift softly back and forth.

A cracked window lets in a feeble amount of light.

You see a phone, wallet, and keys on the table across the room.

You can also see a tattered novel here.

>x bulletin board
A page pinned to the board suggests that Mr. Roaldmann's sepsis complication has reached a critical stage. 
 It's difficult to read the small print, so you quickly give up.

>take all
keys: Taken.
phone: Taken.
wallet: Taken.
tattered novel: Taken.

>get out
You get out of the bed.

Hospital Room
You are in what appears to be a hospital room. The walls are bare save for a bulletin board.

A door across the room is slightly ajar. Outside, voices drift softly back and forth.

A cracked window lets in a feeble amount of light.

>remove iv drip
You wrap your fingers around the needle and yank out the IV drip. A small trail of blood runs down your arm.

* * *

>e
Hospital Room (in the bed)
You are in what appears to be a hospital room. The walls are bare save for a bulletin board.

The door across the room has been tightly locked.

A cracked window lets in a feeble amount of light.

>e
You would have to get out of the bed first.

>get out
You get out of the bed.

Hospital Room
You are in what appears to be a hospital room. The walls are bare save for a bulletin board.

The door across the room has been tightly locked.

A cracked window lets in a feeble amount of light.

>remove iv drip
You wrap your fingers around the needle and yank out the IV drip. A small trail of blood runs down your arm.

>door
That's not a verb I recognise.

>x door
You see nothing special about the hall door.

>e
(first opening the hall door)
The door is locked tightly.

>unlock door with keys
You unlock the hall door.

>open window
You open the cracked window.

>s
Grassy Slope
The meadow outside the hospital is peaceful and quiet. The sun, directly above, warms your face. 

A deep and raging river runs through to the south. Further, a dark forest looms.

>e
Hospital Room (in the bed)
You are in what appears to be a hospital room. The walls are bare save for a bulletin board.

A cracked window lets in a feeble amount of light.

The door across the room has been tightly locked.

>remove iv drip
You wrap your fingers around the needle and yank out the IV drip. A small trail of blood runs down your arm.

>get out
You get out of the bed.

Hospital Room
You are in what appears to be a hospital room. The walls are bare save for a bulletin board.

A cracked window lets in a feeble amount of light.

The door across the room has been tightly locked.

>s
Grassy Slope
The meadow outside the hospital is peaceful and quiet. The sun, directly above, warms your face. 

A deep and raging river runs through to the south. Further, a dark forest looms.

* * *

>w
Riverbank
You arrive at a small peninsula in the riverbank. An unkempt woman sits on the porch of a small hut, absentmindedly tapping the ground beside her with a blackened fire poker.

A rickety bridge extends toward the opposite bank. It sways gently into the wind.

The woman's scratching forms a dreamlike rhythm...

>x hut
You can't see any such thing.

>in
Hut
The hut is small and bare, with only the barest necesseties.

You can see tuna here.

>take tuna
Taken.

>leave
Riverbank
You arrive at a small peninsula in the riverbank. An unkempt woman sits on the porch of a small hut, absentmindedly tapping the ground beside her with a blackened fire poker.

A rickety bridge extends toward the opposite bank. It sways gently into the wind.

The woman's scratching forms a dreamlike rhythm...

>talk to woman
To start a conversation, try to ASK a woman ABOUT something.

>ask woman about river
The woman is willing to guide travelers across the river for a small fee - one dollar will do. 

The woman's scratching forms a dreamlike rhythm...

>ask woman about tuna
There is no reply.

The woman's scratching forms a dreamlike rhythm...

>ask woman about her name
There is no reply.

The woman's scratching forms a dreamlike rhythm...

* * *

>get out
You get out of the bed.

Hospital Room
You are in what appears to be a hospital room. The walls are bare save for a bulletin board. 

A door across the room is slightly ajar. Outside, voices drift softly back and forth.

A cracked window lets in a feeble amount of light.

>remove iv drip
You wrap your fingers around the needle and yank out the IV drip. A small trail of blood runs down your arm.

* * *

>s
Grassy Slope
The meadow outside the hospital is peaceful and quiet. The sun, directly above, warms your face. 

A deep and raging river runs through to the south. Further, a dark forest looms.

>e
The meadow soon gives way to the hospital parking lot, where you are quickly apprehended by security
Hospital Room (in the bed)
You are in what appears to be a hospital room. The walls are bare save for a bulletin board.

A cracked window lets in a feeble amount of light.

A door across the room is slightly ajar. Outside, voices drift softly back and forth.

You can also see a bulletin board here.

>s
You would have to get out of the bed first.

>get out
You get out of the bed.

Hospital Room
You are in what appears to be a hospital room. The walls are bare save for a bulletin board.

A cracked window lets in a feeble amount of light.

A door across the room is slightly ajar. Outside, voices drift softly back and forth.

You can also see a bulletin board here.

>remove iv drip
You yank out the IV drip from your arm.

* * *

>s
Grassy Slope
The meadow outside the hospital is peaceful and quiet. The sun, directly above, warms your face. 

A deep and raging river runs through to the south. Further, a dark forest looms.

>cross river
The river is far too wide and dangerous to cross on foot. Best to find another way.

>w
You meander west along the riverbank for what seems like hours. Above you the sun barely moves in the sky, its rays continuing to illuminate your surroundings with a golden glow.

Riverbank
You see a hut in the distance

A rickety bridge extends toward the opposite bank. It sways gently into the wind.

An unkempt woman sits on the porch of the hut, fanning herself slowly with a folded newspaper.

* * *

>s
Grassy Slope
The meadow outside the hospital is peaceful and quiet. The sun, directly above, warms your face. 

A deep and raging river runs through to the south. Further, a dark forest looms.

>s
The river is far too wide and dangerous to cross on foot. Best to find another way. Continue anyway?

>yes
Hospital Room (in the bed)
You are in what appears to be a hospital room. The walls are bare save for a bulletin board. A small puddle has formed on the ground.

A cracked window lets in a feeble amount of light.

The door across the room has been tightly locked.

>x bulletin board
A page pinned to the board suggests that Mr. Roaldmann's sepsis complication has reached a critical stage. 
Another page notes that he has been found wandering the hospital premises and is to be put under tighter security. It's difficult to read the small print, so you quickly give up.

>s
You would have to get out of the bed first.

>get out
You get out of the bed.

Hospital Room
You are in what appears to be a hospital room. The walls are bare save for a bulletin board. A small puddle has formed on the ground.

A cracked window lets in a feeble amount of light.

The door across the room has been tightly locked.

>remove iv drip
You wrap your fingers around the needle and yank out the IV drip. A small trail of blood runs down your arm.

* * *

>out
But you aren't in anything at the moment.

>s
Grassy Slope
The meadow outside the hospital is peaceful and quiet. The sun, directly above, warms your face. 

A deep and raging river runs through to the south. Further, a dark forest looms.

* * *

>w
Riverbank
You arrive at a small peninsula in the riverbank. An unkempt woman sits on the porch of a small hut, absentmindedly tapping the ground beside her with a blackened fire poker.

A rickety bridge extends toward the opposite bank. It sways gently into the wind.

The woman's scratching forms a dreamlike rhythm...

>open wallet
You open the wallet, revealing one dollar and a Loungent Technologies ID card.

The woman's scratching forms a dreamlike rhythm...

>give woman dollar
(first taking one dollar)
The woman pockets the money and guides you across the bridge. As you cross she warns you against stepping on several of the bridge planks, which have led more than one traveler to their deaths. Before long you have lost track of which planks are safe to step on.
 She dances away, leaving you at the edge of the forest.

Dark Forest
The forest hums with the chatter of animal life. The trees cast deep shadows across the undergrowth. A faint trail winds south into the undergrowth.

A rickety bridge extends toward the opposite bank. It sways gently into the wind.

>n
There's no trail that way. Attempt to continue?

>yes
Hospital Room (in the bed)
You are in what appears to be a hospital room. The walls are bare save for a bulletin board. A small puddle has formed on the ground.

A cracked window lets in a feeble amount of light.

The door across the room has been tightly locked.

>i
You are carrying:
  leaves
  a tattered novel
  a wallet (open)
    a Loungent Technologies ID card
  a phone
  keys

>eat leaves
That's plainly inedible.

>s
You would have to get out of the bed first.

* * *

>remove iv drip
You wrap your fingers around the needle and yank out the IV drip. A small trail of blood runs down your arm.

>s
Grassy Slope
The meadow outside the hospital is peaceful and quiet. The sun, directly above, warms your face. 

A deep and raging river runs through to the south. Further, a dark forest looms.

* * *

>w
Riverbank
You arrive at a small peninsula in the riverbank. An unkempt woman sits on the porch of a small hut, absentmindedly tapping the ground beside her with a blackened fire poker.

A rickety bridge extends toward the opposite bank. It sways gently into the wind.

The woman's scratching forms a dreamlike rhythm...

>open wallet
That's already open.

The woman's scratching forms a dreamlike rhythm...

>give woman a dollar
You can't see any such thing.

* * *

>take all
keys: Taken.
phone: Taken.
wallet: Taken.
tattered novel: Taken.

>go
You'll have to say which compass direction to go in.

>open window
You open the cracked window.

* * *

>go s
Grassy Slope
The meadow is peaceful and quiet. The sun, directly ahead, warms your face. In the distance to the west you can make out a small shack.

A cracked window lets in a feeble amount of light.

A deep and raging river runs through the meadow to the south. Further, a dark forest looms.

>go we
You can't see any such thing.

>go w
You meander west along the riverbank for what seems like hours. Above you the sun barely moves in the sky, its rays continuing to illuminate your surroundings with a golden glow.

Riverbank
You see a hut in the distance

A rickety bridge extends toward the opposite bank. It sways gently into the wind.

An unkempt woman sits on the porch of the hut, fanning herself slowly with a folded newspaper.

>gie
That's not a verb I recognise.

>give
What do you want to give a woman?

>wallet
(to a woman)
The woman pockets the money and guides you across the bridge. As you cross she warns you against stepping on several of the bridge planks, which have led more than one traveler to their deaths. She laughs gutturally. Below you the river rages loudly.

dark forest
The forest hums with the chatter of animal life. The trees cast deep shadows across the undergrowth. Further in the distance you see a dim light, emnating an orange electric glow.

A rickety bridge extends toward the opposite bank. It sways gently into the wind.

>go s
After pushing aside numerous branches and swatting away flies, you enter a clearing. In the clearing is a railroad station.

railroad station
The railroad station is impeccably architected, with a large archway entrance and beautiful iron grated windows

* * *

>take all
keys: Taken.
phone: Taken.
wallet: Taken.
tattered novel: Taken.

>go door
The hallway is full of hospital staff, bustling to and fro. Eventually, one notices your hospital gown and ushers you back into your room.

* * *

>take all
keys: Taken.
phone: Taken.
wallet: Taken.
tattered novel: Taken.

>open w
You must name something more substantial.

>open window
You open the cracked window.

* * *

>go w
You meander west along the riverbank for what seems like hours. Above you the sun barely moves in the sky, its rays continuing to illuminate your surroundings with a golden glow.

Riverbank
You see a hut in the distance

A rickety bridge extends from toward the opposite bank. It sways gently into the wind.

An unkempt woman sits on the porch of the hut, fanning herself slowly with a folded newspaper.

>give
What do you want to give a woman?

>wallet
(to a woman)
The woman pockets the money and guides you across the bridge. As you cross she warns you against stepping on several of the bridge planks, which have led more than one traveler to their deaths. She laughs gutturally. Below you the river rages loudly.

dark forest
The forest hums with the chatter of animal life. The trees cast deep shadows across the undergrowth. In the distance you see a dim light, emnating an orange electric glow.

A rickety bridge extends from toward the opposite bank. It sways gently into the wind.

>go toward the light
You can't see any such thing.

>go in
train station

>go out
dark forest
The forest hums with the chatter of animal life. The trees cast deep shadows across the undergrowth. In the distance you see a dim light, emnating an orange electric glow.

A rickety bridge extends from toward the opposite bank. It sways gently into the wind.

>west
You can't go that way.

>w
You can't go that way.

>s
You can't go that way.

* * *

>take all
keys: Taken.
phone: Taken.
wallet: Taken.
tattered novel: Taken.

>open window
You open the cracked window.

>get out
You get out of the bed.

Hospital Room
You are in what appears to be a hospital room. The walls are bare save for a bulletin board. 

A door across the room is slightly ajar. Outside, voices drift softly back and forth.

A cracked window lets in a feeble amount of light.

* * *

>s
Grassy Slope
The meadow outside the hospital is peaceful and quiet. The sun, directly above, warms your face. 

A deep and raging river runs through to the south. Further, a dark forest looms.

>w
Riverbank
You arrive at a small peninsula in the riverbank. An unkempt woman sits on the porch of a small hut, absentmindedly tapping the ground beside her with a blackened fire poker.

A rickety bridge extends toward the opposite bank. It sways gently into the wind.

The hut is small and bare, with only the barest necesseties.

The woman's scratching forms a dreamlike rhythm...

>open wallet
You open the wallet, revealing one dollar and a Loungent Technologies ID card.

The woman's scratching forms a dreamlike rhythm...

>give dollar
(to The unkempt woman)
(first taking one dollar)
The woman pockets the money and guides you across the bridge. As you cross she warns you against stepping on several of the bridge planks, which have led more than one traveler to their deaths. Before long you have lost track of which planks are safe to step on.
 She dances away, leaving you at the edge of the forest.

Dark Forest
The forest hums with the chatter of animal life. The trees cast deep shadows across the undergrowth. A faint trail winds south into the undergrowth.

A rickety bridge extends toward the opposite bank. It sways gently into the wind.

>i
You are carrying:
  a tattered novel
  a wallet (open)
    a Loungent Technologies ID card
  a phone
  keys

>s
Railroad Station
The railroad station is impeccably architected, with a large archway entrance and beautiful iron grated windows.

A cat with a beautiful dark coat of fur purrs gently, curled up on the tiled floor.

The man at the ticket counter seems familiar to you somehow.

>x ticket counter
You see nothing special about the The man behind the ticket counter.

>ask the man at the counter about train
You can't see any such thing.

>ask the ticket counter about train
The man behind the ticket counter says that train tickets cost nine thousand dollars.

>in
Train
Looking out the window you see the forest give way to valleys and mountains, and then open plains with the occasional solitary cow. The sun, still yellow in the sky gives clouds a luminance that makes them like appear like marble. The shadow of the railroad car stretches longer and longer toward the horizon, yet the sun remains fixed in the sky, at that golden angle just before dusk. From your seat on the train the country appears both vast and intimate.

>out
Railroad Station
The railroad station is impeccably architected, with a large archway entrance and beautiful iron grated windows.

A cat with a beautiful dark coat of fur purrs gently, curled up on the tiled floor.

The man at the ticket counter seems familiar to you somehow.

>i
You are carrying:
  a tattered novel
  a wallet (open)
    a Loungent Technologies ID card
  a phone
  keys

>give ticket counter id card
(first taking the Loungent Technologies ID card)
The man's eyes widen considerably.
I'm so sorry Sir Roaldmann. For you, there will be no charge.

>i
You are carrying:
  an a train ticket
  a Loungent Technologies ID card
  a tattered novel
  a wallet (open but empty)
  a phone
  keys

>go train
You can't see any such thing.

>enter train
You can't see any such thing.

>train
That's not a verb I recognise.

>in
Train
Looking out the window you see the forest give way to valleys and mountains, and then open plains with the occasional solitary cow. The sun, still yellow in the sky gives clouds a luminance that makes them like appear like marble. The shadow of the railroad car stretches longer and longer toward the horizon, yet the sun remains fixed in the sky, at that golden angle just before dusk. From your seat on the train the country appears both vast and intimate.

* * *

>out
Railroad Station
The railroad station is impeccably architected, with a large archway entrance and beautiful iron grated windows.

A cat with a beautiful dark coat of fur purrs gently, curled up on the tiled floor.

The man at the ticket counter seems familiar to you somehow.

>in
Train
Looking out the window you see the forest give way to valleys and mountains, and then open plains with the occasional solitary cow. The sun, still yellow in the sky gives clouds a luminance that makes them like appear like marble. The shadow of the railroad car stretches longer and longer toward the horizon, yet the sun remains fixed in the sky, at that golden angle just before dusk. From your seat on the train the country appears both vast and intimate.

>read novel
"It seems to me," responded don Quixote, "that you aren't well-versed in adventures-they are giants; and if you're afraid, get away from here and start praying while I go into fierce and unequal battle with them." 
 And saying this, he spurred his horse Rocinante without heeding what his squire Sancho was shouting to him, that he was attacking windmills and not giants. But he was so certain they were giants that he paid no attention to his squire Sancho's shouts, nor did he see what they were, even though he was very close. Rather, he went on shouting: "Do not flee, cowards and vile creatures, for it's just one knight attacking you!": 

A grinding screech jolts you out of Cervantes" intricate world. Looking out the window it seems the train has stopped. The conductor has reappeared and has opened the train door.

>ask conductor about train
There is no reply.

>out
Town Square
You are in a sleepy town square. You can see a saloon to the west and a shuttered general store to the east.

>west
saloon
An unremarkable saloon.

Your nurse from the hospital is absentmindedly drying glasses behind the bar. You blink. The bartender looks up at you quizzically and you realize you certainly made a mistake.

A trio of patrons sit at the far end of the saloon.

>east
Town Square
You are in a sleepy town square. You can see a saloon to the west and a shuttered general store to the east.

>east
The general store is closed, which seems odd for this time of day. Perhaps that's just the way they do things out in the countryside.

>west
saloon
An unremarkable saloon.

Your nurse from the hospital is absentmindedly drying glasses behind the bar. You blink. The bartender looks up at you quizzically and you realize you certainly made a mistake.

A trio of patrons sit at the far end of the saloon.

>x patrons
You can't see any such thing.

>x trio of patrons
You can't see any such thing.

>x scoundrel
You see nothing special about The trio of patrons.

>ask bartender about drink
There is no reply.

>ask bartender for a drink
You can't see any such thing.

>ask bartender about a drink
Would you care for a drink?

>yes
The bartender pours you a Sazerac, the deep orange of the rye whiskey casting a faint glow   on the dusty table. Certainly you haven't had one of these in a while - the hospital's bar service was rather lacking due to its nonexistence.

>i
You are carrying:
  a Sazerac
  an a train ticket
  a Loungent Technologies ID card
  a tattered novel
  a wallet (open but empty)
  a phone
  keys

>leave
But you aren't in anything at the moment.

>east
The bartender gives you a shout - you'll need to finish your drink before you can leave the saloon.

>drink sazerac
There's nothing suitable to drink here.

>drink sazerac
There's nothing suitable to drink here.

* * *

>s
Railroad Station
The railroad station is impeccably architected, with a large archway entrance and beautiful iron grated windows.

A cat with a beautiful dark coat of fur purrs gently, curled up on the tiled floor.

You can also see a ticket counter here.

>x cat
You see nothing special about the black cat.

>pet cat
You stroke the cat absentmindedly.

>i
You are carrying:
  a tattered novel
  a wallet (open)
    a Loungent Technologies ID card
  a phone
  keys

>x ticket counter
The ticket counter seems deserted. However, there is a train waiting at the platform with its doors ajar.

* * *

>open wallet
You open the wallet, revealing one dollar and a Loungent Technologies ID card.

The woman's scratching forms a dreamlike rhythm...

>give woman id card
(first taking the Loungent Technologies ID card)
a woman doesn't seem interested.

The woman's scratching forms a dreamlike rhythm...

>give woman dollar
(first taking one dollar)
The woman pockets the money and guides you across the bridge. As you cross she warns you against stepping on several of the bridge planks, which have led more than one traveler to their deaths. She laughs gutturally. Below you the river rages loudly.

dark forest
The forest hums with the chatter of animal life. The trees cast deep shadows across the undergrowth. A faint trail winds south into the undergrowth.

A rickety bridge extends toward the opposite bank. It sways gently into the wind.

>x bridge
You see nothing special about the bridge.

>x trail
You can't see any such thing.

>x forest
You can't see any such thing.

* * *

>w
Riverbank
You arrive at a small peninsula in the riverbank. An unkempt woman sits on the porch of a small hut, absentmindedly tapping the ground beside her with a blackened fire poker.

A rickety bridge extends toward the opposite bank. It sways gently into the wind.

The hut is small and bare, with only the barest necesseties.

The woman's scratching forms a dreamlike rhythm...

>x hut
In the Hut is tuna.

The woman's scratching forms a dreamlike rhythm...

>take tuna
Taken.

The woman's scratching forms a dreamlike rhythm...

>enter hut
You get into the Hut.

The woman's scratching forms a dreamlike rhythm...

>look
Riverbank (in the Hut)
You arrive at a small peninsula in the riverbank. An unkempt woman sits on the porch of a small hut, absentmindedly tapping the ground beside her with a blackened fire poker.

A rickety bridge extends toward the opposite bank. It sways gently into the wind.

The woman's scratching forms a dreamlike rhythm...

>x
What do you want to examine?

>tuna
You see nothing special about tuna.

The woman's scratching forms a dreamlike rhythm...

>i
You are carrying:
  tuna
  a tattered novel
  a wallet (closed)
  a phone
  keys

The woman's scratching forms a dreamlike rhythm...

>open wallet
You open the wallet, revealing one dollar and a Loungent Technologies ID card.

The woman's scratching forms a dreamlike rhythm...

* * *

>x trail
The trail doesn't seem very well traveled.

>x foret
You can't see any such thing.

>x forest
You can't see any such thing.

>x undergrowth
The forest floor is thick with twisting vines and tree branches.

>s
Railroad Station
The railroad station is impeccably architected, with a large archway entrance and beautiful iron grated windows.

A cat with a beautiful dark coat of fur purrs gently, curled up on the tiled floor.

The man at the ticket counter seems familiar to you somehow.

>x entrance
You can't see any such thing.

>x windows
You can't see any such thing.

>x cat
You see nothing special about the black cat.

>give tuna to cat
You can only do that to something animate.

>give cat tuna
You can only do that to something animate.

>take cat
The cat easily eludes your attempt to capture it.

>pet cat
You stroke the cat absentmindedly.

>x man
You can't see any such thing.

>x the man
You see nothing special about the the man behind the ticket counter.

>ask man about train
You can't see any such thing.

>ask the man about train
The man behind the ticket counter says that train tickets cost nine thousand dollars. An outrageous sum, surely there must be another way? The man shrugs, mumbling something about "degenerate riffraff" and returns to tapping methodically on his desk.

>show man id card
You can't see any such thing.

>show man ID card
You can't see any such thing.

>show the man ID card
(first taking the Loungent Technologies ID card)
The the man behind the ticket counter is unimpressed.

>give the man ID card
The man's eyes widen considerably.
I'm so sorry Sir Roaldmann. For you, there will be no charge.
He hands you a piece of paper and gestures toward the waiting train.

>i
You are carrying:
  a train ticket
  a Loungent Technologies ID card
  tuna
  a tattered novel
  a wallet (open but empty)
  a phone
  keys

>enter
You must supply a noun.

>enter train
You can't see any such thing.

>go in train
You can't see any such thing.

>in
You board the train. You sit down in an empty compartment, which isn't particularly difficult to find. You settle into your seat.

Train
Looking out the window you see the forest give way to valleys and mountains, and then open plains with the occasional solitary cow. The sun, still yellow in the sky gives clouds a luminance that makes them like appear like marble. The shadow of the railroad car stretches longer and longer toward the horizon, yet the sun remains fixed in the sky, at that golden angle just before dusk. From your seat on the train the country appears both vast and intimate.

>out
It would be wise to wait until the train is stopped before attempting to get off! Continue?

* * *

>x window
It's an ordinary train window. Beyond it though lies the changing scenery of the countryside, fields and trees somewhat unfamiliar to you.

>x seat
The train seat is a beautiful white leather.

>read novel
"It seems to me," responded don Quixote, "that you aren't well-versed in adventures-they are giants; and if you're afraid, get away from here and start praying while I go into fierce and unequal battle with them." 
 And saying this, he spurred his horse Rocinante without heeding what his squire Sancho was shouting to him, that he was attacking windmills and not giants. But he was so certain they were giants that he paid no attention to his squire Sancho's shouts, nor did he see what they were, even though he was very close. Rather, he went on shouting: "Do not flee, cowards and vile creatures, for it's just one knight attacking you!": 

A grinding screech jolts you out of Cervantes" intricate world. Looking out the window it seems the train has stopped. The conductor has reappeared and has opened the train door.

>ask conductor about the train
The conductor apologizes, but the train won't be reaching it's final destination today. You'll have to get off here and call a taxi in the next town over.

>out
Town Square
You are in a sleepy town square. You can see a saloon to the west and a shuttered general store to the east.

>n
You can't go that way.

>s
You can't go that way.

>e
The general store is closed, which seems odd for this time of day. Perhaps that's just the way they do things out in the countryside.

>w
saloon
An unremarkable saloon.

Your nurse from the hospital is absentmindedly drying glasses behind the bar. You blink. The bartender looks up at you quizzically and you realize you certainly made a mistake.

A trio of patrons sit at the far end of the saloon.

>ask bartender for a drink
You can't see any such thing.

>ask bartender
What do you want to ask the bartender for?

>ask bartender for drink
You can't see any such thing.

>ask bartender about a drink
Would you care for a drink?

>yes
The bartender pours you a Sazerac, the deep orange of the rye whiskey casting a faint glow on the dusty table. Certainly you haven't had one of these in a while - the hospital's bar service was rather lacking due to its nonexistence.

>i
You are carrying:
  a Sazerac
  a train ticket
  a Loungent Technologies ID card
  tuna
  a tattered novel
  a wallet (open but empty)
  a phone
  keys

>drink sazerac
You quaff the Sazerac. It goes down beautifully. You savor the tart relish of the liquor.
A spitball hits you in the back of the head.

Another spitball hits you in the back of the head.
The other table laughs among themselves.

>i
You are carrying:
  a spitball
  a train ticket
  a Loungent Technologies ID card
  tuna
  a tattered novel
  a wallet (open but empty)
  a phone
  keys

The other table laughs among themselves.

>x spitball
You see nothing special about the spitball.

Another spitball hits you in the back of the head.
The other table laughs among themselves.

>i
You are carrying:
  a spitball
  a train ticket
  a Loungent Technologies ID card
  tuna
  a tattered novel
  a wallet (open but empty)
  a phone
  keys

>ask the men about the town
There is no reply.

Another spitball hits you in the back of the head.
The other table laughs among themselves.

>ask the men about the spitball
As you move toward the far table, the bartender interjects.
 Sir Roaldmann, ignore them. They are drunk. You needn't concern yourself with them.
 Go back to your seat?

>no
Another spitball hits you in the back of the head.
The other table laughs among themselves.

The bartender tremulously asks the other patrons to leave the bar.

>i
You are carrying:
  a spitball
  a train ticket
  a Loungent Technologies ID card
  tuna
  a tattered novel
  a wallet (open but empty)
  a phone
  keys

The bartender tremulously asks the other patrons to leave the bar.

>look
saloon
An unremarkable saloon.

A naked dagger clatters to the floor at your feet. You look up, and see an old man sitting in a shadowy corner. He nods at you, slowly.

Your nurse from the hospital is absentmindedly drying glasses behind the bar. You blink. The bartender looks up at you quizzically and you realize you certainly made a mistake.

A trio of patrons sit at the far end of the saloon.

The bartender tremulously asks you to leave the bar.

>take knife
The cold steel feels nearly hot beneath your fingers. As you pick up the dagger, the other men get up from their seats and motion you to follow them outside.

Another spitball hits you in the back of the head.
The other table laughs among themselves.

>leave
You follow the men outside, under the open sky. Although you are without hope, you are also, for some reason, without fear. This was the death you had chosen, or dreamt.

    *** The End ***

Would you like to RESTART, RESTORE a saved game, QUIT or UNDO the last command?

* * *

>go s
Grassy Slope
The meadow is peaceful and quiet. The sun, directly ahead, warms your face. In the distance to the west you can make out a small shack.

A cracked window lets in a feeble amount of light.

A deep and raging river runs through the meadow to the south. Further, a dark forest looms.

>w
You meander west along the riverbank for what seems like hours. Above you the sun barely moves in the sky, its rays continuing to illuminate your surroundings with a golden glow.

Riverbank
You see a hut in the distance

A rickety bridge extends toward the opposite bank. It sways gently into the wind.

An unkempt woman sits on the porch of the hut, fanning herself slowly with a folded newspaper.

* * *

>s
After pushing aside numerous branches and swatting away flies, you enter a clearing. In the clearing is a railroad station.

railroad station
The railroad station is impeccably architected, with a large archway entrance and beautiful iron grated windows.

A cat with a beautiful dark coat of fur purrs gently, curled up on the tiled floor.

You can also see a ticket counter here.

>s
traincar
You board the train. The conductor walks by, and instead of checking for your ticket merely gives you a friendly smile. You sit down in an empty compartment, which isn't particularly difficult to find. Unperturbed, you settle into your seat as the train clunks into motion.

Looking out the window you see the forest give way to valleys and mountains, and then open plains with the occasional solitary cow. The sun, still yellow in the sky gives clouds a luminance that makes them like appear like marble. The shadow of the railroad car stretches longer and longer toward the horizon, yet the sun remains fixed in the sky, at that golden angle just before dusk. From your seat on the train the country appears both vast and intimate.

>read novel
It's a dog eared copy of Don Quixote, by Miguel Cervantes.

* * *

>x window
It's an ordinary train window. Beyond it though lies the changing scenery of the countryside, fields and trees somewhat unfamiliar to you.

>x cow
You can't see any such thing.

>read
What do you want to read?

>novel
It's a dog eared copy of Don Quixote, by Miguel Cervantes.

>read the novel
It's a dog eared copy of Don Quixote, by Miguel Cervantes.

* * *

>open window
You open the cracked window.

>go through window
Grassy Slope
The meadow is peaceful and quiet. The sun, directly ahead, warms your face.

A cracked window lets in a feeble amount of light.

A deep and raging river runs through the meadow to the south. Further, a dark forest looms.

>go south
The river is far too wide and dangerous to cross on foot. Best to find another way.

>go north
Hospital Room
You are in what appears to be a hopsital room.

A cracked window lets in a feeble amount of light.

A door across the room is slightly ajar. Outside voices drift softly back and forth.

>go south
Grassy Slope
The meadow is peaceful and quiet. The sun, directly ahead, warms your face.

A cracked window lets in a feeble amount of light.

A deep and raging river runs through the meadow to the south. Further, a dark forest looms.

>go east
You can't go that way.

>go west
You can't go that way.

* * *

>open window
You open the cracked window.

>remove iv drip
You wrap your fingers around the needle and yank out the IV drip. A small trail of blood runs down your arm.

>get out
You get out of the bed.

Hospital Room
You are in what appears to be a hospital room. The walls are bare save for a bulletin board. 

A door across the room is slightly ajar. Outside, voices drift softly back and forth.

A cracked window lets in a feeble amount of light.

>s
Grassy Slope
The meadow outside the hospital is peaceful and quiet. The sun, directly above, warms your face. 

A deep and raging river runs through to the south. Further, a dark forest looms.

* * *

>w
Riverbank
You arrive at a small peninsula in the riverbank. An unkempt woman sits on the porch of a small hut, absentmindedly tapping the ground beside her with a blackened fire poker.

A rickety bridge extends toward the opposite bank. It sways gently into the wind.

The hut is small and bare, with only the barest necesseties.

The woman's scratching forms a dreamlike rhythm...

>give woman a dollar
You can't see any such thing.

>open wallet
You open the wallet, revealing one dollar and a Loungent Technologies ID card.

The woman's scratching forms a dreamlike rhythm...

>give woman a dollar
(first taking one dollar)
The woman pockets the money and guides you across the bridge. As you cross she warns you against stepping on several of the bridge planks, which have led more than one traveler to their deaths. She laughs gutturally. Below you the river rages loudly.

dark forest
The forest hums with the chatter of animal life. The trees cast deep shadows across the undergrowth. A faint trail winds south into the undergrowth.

A rickety bridge extends toward the opposite bank. It sways gently into the wind.

>n
The forest extends deeply in all directions. It's too thick to go that way.

>s
Railroad Station
The railroad station is impeccably architected, with a large archway entrance and beautiful iron grated windows.

A cat with a beautiful dark coat of fur purrs gently, curled up on the tiled floor.

You can also see a ticket counter here.

>x ticket counter
The ticket counter seems deserted. However, there is a train waiting at the platform with its doors ajar.

>go in
Train
Looking out the window you see the forest give way to valleys and mountains, and then open plains with the occasional solitary cow. The sun, still yellow in the sky gives clouds a luminance that makes them like appear like marble. The shadow of the railroad car stretches longer and longer toward the horizon, yet the sun remains fixed in the sky, at that golden angle just before dusk. From your seat on the train the country appears both vast and intimate.

>read
What do you want to read?

>novel
You read: "It seems to me," responded don Quixote, "that you aren't well-versed in adventures-they are giants; and if you're afraid, get away from here and start praying while I go into fierce and unequal battle with them." 
 And saying this, he spurred his horse Rocinante without heeding what his squire Sancho was shouting to him, that he was attacking windmills and not giants. But he was so certain they were giants that he paid no attention to his squire Sancho's shouts, nor did he see what they were, even though he was very close. Rather, he went on shouting: "Do not flee, cowards and vile creatures, for it's just one knight attacking you!"

A grinding screech jolts you out of Cervantes" intricate world. Looking out the window it seems the train has stopped. The conductor has reappeared and has opened the train door.

>go out
town square
You are in a sleepy town square. You can see a saloon to the west and a shuttered general store to the east.

A large crowd is gathered in the square. You can't quite make out what they're saying, but they seem moderately upset.

>n
You can't go that way.

* * *

>open wallet
You open the wallet, revealing one dollar and a Loungent Technologies ID card.

The woman's scratching forms a dreamlike rhythm...

>give dollar
Dark Forest
The forest hums with the chatter of animal life. The trees cast deep shadows across the undergrowth. A faint trail winds south into the undergrowth.

A rickety bridge extends toward the opposite bank. It sways gently into the wind.

>s
Railroad Station
The railroad station is impeccably architected, with a large archway entrance and beautiful iron grated windows.

A cat with a beautiful dark coat of fur purrs gently, curled up on the tiled floor.

The man at the ticket counter seems familiar to you somehow.

>give man id card
(first taking the Loungent Technologies ID card)
The the man behind the ticket counter doesn't seem interested.

>show man id card
The man's eyes widen considerably.
I'm so sorry Sir Roaldmann. For you, there will be no charge.
He hands you a piece of paper and gestures toward the waiting train.

>enter train
You can't see any such thing.

>enter faketrain
You board the train. You sit down in an empty compartment, which isn't particularly difficult to find. You settle into your seat.

Train
Looking out the window you see the forest give way to valleys and mountains, and then open plains with the occasional solitary cow. The sun, still yellow in the sky gives clouds a luminance that makes them like appear like marble. The shadow of the railroad car stretches longer and longer toward the horizon, yet the sun remains fixed in the sky, at that golden angle just before dusk. From your seat on the train the country appears both vast and intimate.

* * *

>s
Railroad Station
The railroad station is impeccably architected, with a large archway entrance and beautiful iron grated windows.

A cat with a beautiful dark coat of fur purrs gently, curled up on the tiled floor.

The man at the ticket counter seems familiar to you somehow.

>show man id card
(first taking the Loungent Technologies ID card)
The man's eyes widen considerably.
I'm so sorry Sir Roaldmann. For you, there will be no charge.
He hands you a piece of paper and gestures toward the waiting train.

>board train
You board the train. You sit down in an empty compartment, which isn't particularly difficult to find. You settle into your seat.

Train
Looking out the window you see the forest give way to valleys and mountains, and then open plains with the occasional solitary cow. The sun, still yellow in the sky gives clouds a luminance that makes them like appear like marble. The shadow of the railroad car stretches longer and longer toward the horizon, yet the sun remains fixed in the sky, at that golden angle just before dusk. From your seat on the train the country appears both vast and intimate.

* * *

>read novel
"It seems to me," responded don Quixote, "that you aren't well-versed in adventures-they are giants; and if you're afraid, get away from here and start praying while I go into fierce and unequal battle with them." 
 And saying this, he spurred his horse Rocinante without heeding what his squire Sancho was shouting to him, that he was attacking windmills and not giants. But he was so certain they were giants that he paid no attention to his squire Sancho's shouts, nor did he see what they were, even though he was very close. Rather, he went on shouting: "Do not flee, cowards and vile creatures, for it's just one knight attacking you!": 

A grinding screech jolts you out of Cervantes" intricate world. Looking out the window it seems the train has stopped. The conductor has reappeared and has opened the train door.

>leave
Town Square
You are in a sleepy town square. You can see a saloon to the west and a shuttered general store to the east.

>board train
You can't see any such thing.

>west
saloon
An unremarkable saloon. Your nurse from the hospital is absentmindedly drying glasses behind the bar. You blink. The bartender looks up at you quizzically and you realize you certainly made a mistake, misrecognizing him for someone else.

A trio of patrons sit at the far end of the saloon.

>leave
Town Square
You are in a sleepy town square. You can see a saloon to the west and a shuttered general store to the east.

>west
saloon
An unremarkable saloon. 

A trio of patrons sit at the far end of the saloon.

>ask the bartender about a drink
Would you care for a drink?

>yes
The bartender pours you a Sazerac, the deep orange of the rye whiskey casting a faint glow on the dusty table. Certainly you haven't had one of these in a while - the hospital's bar service was rather lacking due to its nonexistence.

>i
You are carrying:
  a Sazerac
  a train ticket
  a Loungent Technologies ID card
  a tattered novel
  a wallet (open but empty)
  a phone
  keys

>x sazerac
You see nothing special about the Sazerac.

>drink sazerac
Unexpectedly, a spitball hits you in the back of the head.

saloon
An unremarkable saloon. 

A trio of patrons sit at the far end of the saloon.

Another spitball hits you in the back of the head.
The other table laughs among themselves....

* * *

>w
Riverbank
You arrive at a small peninsula in the riverbank. An unkempt woman sits on the porch of a small hut, absentmindedly tapping the ground beside her with a blackened fire poker.

A rickety bridge extends toward the opposite bank. It sways gently into the wind.

The hut is small and bare, with only the barest necesseties.

The woman's scratching forms a dreamlike rhythm...

>take tuna
Taken.

The woman's scratching forms a dreamlike rhythm...

>open wallet
You open the wallet, revealing one dollar and a Loungent Technologies ID card.

The woman's scratching forms a dreamlike rhythm...

* * *

>s
Railroad Station
The railroad station is impeccably architected, with a large archway entrance and beautiful iron grated windows.

A cat with a beautiful dark coat of fur purrs gently, curled up on the tiled floor.

The man at the ticket counter seems familiar to you somehow.

>in
The conductor bars you from entering the train without a ticket.

>go train
You can't see any such thing.

>go in
The conductor bars you from entering the train without a ticket.

>go on
You can't see any such thing.

>enter train
You can't see any such thing.

>board train
That's not a verb I recognise.

>ask man at ticket counter about train
I didn't understand that sentence.

>ask the man at ticket counter about train
I didn't understand that sentence.

>ask the man about train
The man behind the ticket counter says that train tickets cost nine thousand dollars. An outrageous sum, surely there must be another way? The man shrugs, mumbling something about "degenerate riffraff" and returns to tapping methodically on his desk.

>show man ID card
(first taking the Loungent Technologies ID card)
The man's eyes widen considerably.
I'm so sorry Sir Roaldmann. For you, there will be no charge.
He hands you a piece of paper and gestures toward the waiting train.

>go in
You board the train. You sit down in an empty compartment, which isn't particularly difficult to find. You settle into your seat.

Train
Looking out the window you see the forest give way to valleys and mountains, and then open plains with the occasional solitary cow. The sun, still yellow in the sky gives clouds a luminance that makes them like appear like marble. The shadow of the railroad car stretches longer and longer toward the horizon, yet the sun remains fixed in the sky, at that golden angle just before dusk. From your seat on the train the country appears both vast and intimate.

>out
It would be wise to wait until the train is stopped before attempting to get off! Continue?

* * *

>ask conductor about train
The conductor apologizes, but the train won't be reaching it's final destination today. You'll have to get off here and call a taxi in the next town over.

>leave
Town Square
You are in a sleepy town square. You can see a saloon to the west and a shuttered general store to the east.

>w
saloon
An unremarkable saloon.

Your nurse from the hospital is absentmindedly drying glasses behind the bar. You blink. The bartender looks up at you quizzically and you realize you certainly made a mistake.

A trio of patrons sit at the far end of the saloon.

>ask patrons about town
You can't see any such thing.

>ask trio about town
You can't see any such thing.

>ask the men about town
There is no reply.

>order a drink
That's not a verb I recognise.

>ask the bartender about a drink
Would you care for a drink?

* * *

>yes
The bartender pours you a Sazerac, the deep orange of the rye whiskey casting a faint glow on the dusty table. Certainly you haven't had one of these in a while - the hospital's bar service was rather lacking due to its nonexistence.

>drink sazerac
A spitball hits you in the back of the head.

>i
You are carrying:
  a spitball
  a train ticket
  a Loungent Technologies ID card
  tuna
  a tattered novel
  a wallet (open but empty)
  a phone
  keys

The other table laughs among themselves....

>ask the other table about the spitball
(the trio of patrons about that)
As you move toward the far table, the bartender interjects.
 Sir Roaldmann, ignore them. They are drunk. You needn't concern yourself with them.
 Go back to your seat?

>no
A naked dagger clatters to the floor at your feet. You look up, and see an old man sitting in a shadowy corner. He nods at you, slowly
The bartender tremulously asks you to leave the bar.

>x dagger
It's a dagger, sharp enough to draw blood. You would have no idea how to use this in a fight, as you have no fighting experience....

The bartender tremulously asks the other patrons to leave the bar.

>x knife
It's a dagger, sharp enough to draw blood. You would have no idea how to use this in a fight, as you have no fighting experience....

The bartender tremulously asks you to leave the bar.

>x trio
You can't see any such thing.

>x patrons
You can't see any such thing.

>x the men
You see nothing special about the trio of patrons.

The bartender tremulously asks you to leave the bar.

>look
saloon
An unremarkable saloon.

Your nurse from the hospital is absentmindedly drying glasses behind the bar. You blink. The bartender looks up at you quizzically and you realize you certainly made a mistake.

A trio of patrons sit at the far end of the saloon.

You can also see a knife here.

Another spitball hits you in the back of the head.

The bartender tremulously asks the other patrons to leave the bar.

>i
You are carrying:
  a spitball
  a train ticket
  a Loungent Technologies ID card
  tuna
  a tattered novel
  a wallet (open but empty)
  a phone
  keys

The bartender tremulously asks you to leave the bar.

>take knife
The cold steel feels nearly hot beneath your fingers. As you pick up the dagger, the other men get up from their seats and motion you to follow them outside.

>look
saloon
An unremarkable saloon.

Your nurse from the hospital is absentmindedly drying glasses behind the bar. You blink. The bartender looks up at you quizzically and you realize you certainly made a mistake.

A trio of patrons sit at the far end of the saloon.

>leave
You follow the men outside, under the open sky. Although you are without hope, you are also, for some reason, without fear. This was the death you had chosen, or dreamt.

    *** The End ***

Would you like to RESTART, RESTORE a saved game, QUIT or UNDO the last command?

* * *

>w
You meander west along the riverbank for what seems like hours. Above you the sun barely moves in the sky, its rays continuing to illuminate your surroundings with a golden glow.

Riverbank
You see a hut in the distance

A rickety bridge extends toward the opposite bank. It sways gently into the wind.

An unkempt woman sits on the porch of the hut, fanning herself slowly with a folded newspaper.

>give wallet
(to a woman)
The woman pockets the money and guides you across the bridge. As you cross she warns you against stepping on several of the bridge planks, which have led more than one traveler to their deaths. She laughs gutturally. Below you the river rages loudly.

dark forest
The forest hums with the chatter of animal life. The trees cast deep shadows across the undergrowth. Further to the south you see a faint orange electric glow.

A rickety bridge extends toward the opposite bank. It sways gently into the wind.

>s
After pushing aside numerous branches and swatting away flies, you enter a clearing. In the clearing is a railroad station.

railroad station
The railroad station is impeccably architected, with a large archway entrance and beautiful iron grated windows.

A cat with a beautiful dark coat of fur purrs gently, curled up on the tiled floor.

You can also see a ticket counter here.

>x ticket counter
The ticket counter seems deserted. However, there is a train waiting at the southern platform with its doors ajar.

>pet cat
You stroke the cat absentmindedly.

>take cat
The cat easily eludes your attempt to capture it.

>enter train
You can't see any such thing.

>go to train
You can't see any such thing.

>go s
traincar
You board the train. The conductor walks by, and instead of checking for your ticket merely gives you a friendly smile. You sit down in an empty compartment, which isn't particularly difficult to find. Unperturbed, you settle into your seat as the train clunks into motion.

Looking out the window you see the forest give way to valleys and mountains, and then open plains with the occasional solitary cow. The sun, still yellow in the sky gives clouds a luminance that makes them like appear like marble. The shadow of the railroad car stretches longer and longer toward the horizon, yet the sun remains fixed in the sky, at that golden angle just before dusk. From your seat on the train the country appears both vast and intimate.

You can also see a train door here.

>open train door
You open the train door.

>pet window
That wouldn't make very much sense
You pet the train window

>read novel
You read: "It seems to me," responded don Quixote, "that you aren't well-versed in adventures-they are giants; and if you're afraid, get away from here and start praying while I go into fierce and unequal battle with them." 
 And saying this, he spurred his horse Rocinante without heeding what his squire Sancho was shouting to him, that he was attacking windmills and not giants. But he was so certain they were giants that he paid no attention to his squire Sancho's shouts, nor did he see what they were, even though he was very close. Rather, he went on shouting: "Do not flee, cowards and vile creatures, for it's just one knight attacking you!"

A grinding screech jolts you out of Cervantes" intricate world. Looking out the window it seems the train has stopped.

>ask conductor about train
The conductor apologizes, but the train won't be reaching it's final destination today. You'll have to get off here and call a taxi in the next town over.

>leave
But you aren't in anything at the moment.

>leave train
I only understood you as far as wanting to leave.

>go s
You trek for a half mile along the train tracks, the yellow sun continuing to illuminate the great grassy plain around you with a golden aura.

town square
You are in a sleepy town square. You can see a saloon to the west and a shuttered general store to the east.

A shady looking figure lurks in the corner.

You can also see a train door here.

>ask the man about something
You can only do that to something animate.

>ask the shady man about something
You can only do that to something animate.

>ask the shady man about stuff
You can only do that to something animate.

>go w
saloon
An empty saloon.

With no customers, the bartender is absentmindedly drying glasses behind the bar.

>ask bartender about cabs
Unfortunately the taxi drivers are out on strike today. You might have seen them out in the square. If you're not in a rush, it might be a good idea to stay in town for the night. Would you care for a drink?

Please answer yes or no.

>no
The bartender shrugs, and returns to polishing glasses.

>ask bartender about cabs
Unfortunately the taxi drivers are out on strike today. You might have seen them out in the square. If you're not in a rush, it might be a good idea to stay in town for the night. Would you care for a drink?

* * *

Please answer yes or no.

>yes
The bartender pours you a Sazerac, the deep orange of the rye whiskey casting a faint glow on the dusty table. Certainly you haven't had one of these in a while - the hospital's bar service was rather lacking due to its nonexistence.

>leave
But you aren't in anything at the moment.

>go e
There's not much to see in that direction.

* * *

>take all
keys: Taken.
phone: Taken.
wallet: Taken.
tattered novel: Taken.

>read novel
It's a dog eared copy of Don Quixote, by Miguel Cervantes.

* * *

>take all
keys: Taken.
phone: Taken.
wallet: Taken.
tattered novel: Taken.

>remove iv drip
You wrap your fingers around the needle and yank out the IV drip. A small trail of blood runs down your arm.

* * *

>get out
You get out of the bed.

Hospital Room
You are in what appears to be a hospital room. The walls are bare save for a bulletin board. 

A door across the room is slightly ajar. Outside, voices drift softly back and forth.

A cracked window lets in a feeble amount of light.

>leave
But you aren't in anything at the moment.

>s
The window is shut.

>open window
You open the cracked window.

* * *

>x hut
You can't see any such thing.

>enter hut
You can't see any such thing.

* * *

>open window
You open the cracked window.

>get out
You get out of the bed.

Hospital Room
You are in what appears to be a hospital room. The walls are bare save for a bulletin board.

A door across the room is slightly ajar. Outside, voices drift softly back and forth.

A cracked window lets in a feeble amount of light.

You can also see a bulletin board here.

>s
Grassy Slope
The meadow outside the hospital is peaceful and quiet. The sun, directly above, warms your face. 

A deep and raging river runs through to the south. Further, a dark forest looms.

* * *

>w
Riverbank
You arrive at a small peninsula in the riverbank. An unkempt woman sits on the porch of a small hut, absentmindedly tapping the ground beside her with a blackened fire poker.

A rickety bridge extends toward the opposite bank. It sways gently into the wind.

The woman's scratching forms a dreamlike rhythm...

>take poker
You can't see any such thing.

>x hut
You can't see any such thing.

>open wallet
You open the wallet, revealing one dollar and a Loungent Technologies ID card.

The woman's scratching forms a dreamlike rhythm...

* * *

>give woman a dollar
(first taking one dollar)
The woman pockets the money and guides you across the bridge. As you cross she warns you against stepping on several of the bridge planks, which have led more than one traveler to their deaths. She laughs gutturally. Below you the river rages loudly.

dark forest
The forest hums with the chatter of animal life. The trees cast deep shadows across the undergrowth. A faint trail winds south into the undergrowth.

A rickety bridge extends toward the opposite bank. It sways gently into the wind.

>s
Railroad Station
The railroad station is impeccably architected, with a large archway entrance and beautiful iron grated windows.

A cat with a beautiful dark coat of fur purrs gently, curled up on the tiled floor.

You can also see a ticket counter here.

* * *

>x ticket counter
The ticket counter seems deserted. However, there is a train waiting at the platform with its doors ajar.

>in
Train
Looking out the window you see the forest give way to valleys and mountains, and then open plains with the occasional solitary cow. The sun, still yellow in the sky gives clouds a luminance that makes them like appear like marble. The shadow of the railroad car stretches longer and longer toward the horizon, yet the sun remains fixed in the sky, at that golden angle just before dusk. From your seat on the train the country appears both vast and intimate.

>out
Railroad Station
The railroad station is impeccably architected, with a large archway entrance and beautiful iron grated windows.

A cat with a beautiful dark coat of fur purrs gently, curled up on the tiled floor.

You can also see a ticket counter here.

>in
Train
Looking out the window you see the forest give way to valleys and mountains, and then open plains with the occasional solitary cow. The sun, still yellow in the sky gives clouds a luminance that makes them like appear like marble. The shadow of the railroad car stretches longer and longer toward the horizon, yet the sun remains fixed in the sky, at that golden angle just before dusk. From your seat on the train the country appears both vast and intimate.

>showme train
(the train window)
train window - thing
location: in the Train
singular-named, improper-named; unlit, inedible, portable, noticeable
list grouping key: none
printed name: "train window"
printed plural name: none
indefinite article: none
description: "It's an ordinary train window. Beyond it though lies the changing scenery of the countryside, fields and trees somewhat unfamiliar to you."
initial appearance: "Looking out the window you see the forest give way to valleys and mountains, and then open plains with the occasional solitary cow. The sun, still yellow in the sky gives clouds a luminance that makes them like appear like marble. The shadow of the railroad car stretches longer and longer toward the horizon, yet the sun remains fixed in the sky, at that golden angle just before dusk. From your seat on the train the country appears both vast and intimate."
printing: "blank"

>use phone
You turn on the phone. There are no unread messages.:

>read novel
"It seems to me," responded don Quixote, "that you aren't well-versed in adventures-they are giants; and if you're afraid, get away from here and start praying while I go into fierce and unequal battle with them." 
 And saying this, he spurred his horse Rocinante without heeding what his squire Sancho was shouting to him, that he was attacking windmills and not giants. But he was so certain they were giants that he paid no attention to his squire Sancho's shouts, nor did he see what they were, even though he was very close. Rather, he went on shouting: "Do not flee, cowards and vile creatures, for it's just one knight attacking you!": 

A grinding screech jolts you out of Cervantes" intricate world. Looking out the window it seems the train has stopped. The conductor has reappeared and has opened the train door.

* * *

>ask conductor about train
There is no reply.

>look
Train
Looking out the window you see the forest give way to valleys and mountains, and then open plains with the occasional solitary cow. The sun, still yellow in the sky gives clouds a luminance that makes them like appear like marble. The shadow of the railroad car stretches longer and longer toward the horizon, yet the sun remains fixed in the sky, at that golden angle just before dusk. From your seat on the train the country appears both vast and intimate.

You can also see a conductor here.

>ask conductor about the train
There is no reply.

>ask conductor about the stopped train
There is no reply.

>ask conductor about where the train is
There is no reply.

>out
Town Square
You are in a sleepy town square. You can see a saloon to the west and a shuttered general store to the east.

A large crowd is gathered in the square. You can't quite make out what they're saying, but they seem moderately upset.

>w
saloon
An empty saloon.

Your nurse from the hospital is absentmindedly drying glasses behind the bar. You blink. The bartender looks up at you quizzically and you realize you certainly made a mistake.

>ask bartender
What do you want to ask the bartender for?

>drink
What do you want to drink?

>sazerac
You can't see any such thing.

>ask bartender about drink
There is no reply.

>ask bartender about drinks
There is no reply.

>ask bartender for drinks
You can't see any such thing.

>ask bartender about drinking
There is no reply.

>e
Town Square
You are in a sleepy town square. You can see a saloon to the west and a shuttered general store to the east.

A large crowd is gathered in the square. You can't quite make out what they're saying, but they seem moderately upset.

>ask crowd
What do you want to ask crowd for?

>sdf
You can't see any such thing.

>ask crowd about whatever
You pull someone out of the crowd.
Angry, they push you away derisively, and you stumble backward, stepping onto someone's toe behind you. Somewhat dazed, you realize the crowd's jeers are now directed at you, taunting and insulting. But how did they learn your name? A man is standing in front of you, gesticulating violently. He pulls out a knife with a snarl, twirling it menacingly around his fingers
Out of the corner of your eye an object flies through the air and lands at your feet. It's a naked dagger.
 Take it?

>yes
    *** The End ***

Would you like to RESTART, RESTORE a saved game, QUIT or UNDO the last command?

>restart
elsur
An Interactive Fiction
Release 1 / Serial number 201028 / Inform 7 build 6M62 (I6/v6.34 lib 6/12N) SD

Hospital Room (in the bed)
You are in what appears to be a hospital room. The walls are bare save for a bulletin board.

A door across the room is slightly ajar. Outside, voices drift softly back and forth.

A cracked window lets in a feeble amount of light.

You see a phone, wallet, and keys on the table across the room.

You can also see a bulletin board and a tattered novel here.

* * *

>remove iv drip
You wrap your fingers around the needle and yank out the IV drip. A small trail of blood runs down your arm.

>s
The window is shut.

* * *

>get out
You get out of the bed.

Hospital Room
You are in what appears to be a hospital room. The walls are bare save for a bulletin board.

A door across the room is slightly ajar. Outside, voices drift softly back and forth.

A cracked window lets in a feeble amount of light.

>s
Grassy Slope
The meadow outside the hospital is peaceful and quiet. The sun, directly above, warms your face. 

A deep and raging river runs through to the south. Further, a dark forest looms.

>e
Hospital Room (in the bed)
You are in what appears to be a hospital room. The walls are bare save for a bulletin board.

A cracked window lets in a feeble amount of light.

A door across the room is slightly ajar. Outside, voices drift softly back and forth.

* * *

>take all
keys: Taken.
phone: Taken.
wallet: Taken.
tattered novel: Taken.

>unattach iv drip
You yank out the IV drip from your arm.

>open window
You open the cracked window.

* * *

>s
You would have to get out of the bed first.

>get out
You get out of the bed.

Hospital Room
You are in what appears to be a hospital room. The walls are bare save for a bulletin board.

A door across the room is slightly ajar. Outside, voices drift softly back and forth.

A cracked window lets in a feeble amount of light.

You can also see a bulletin board here.

* * *

>s
Grassy Slope
The meadow outside the hospital is peaceful and quiet. The sun, directly above, warms your face. 

A deep and raging river runs through to the south. Further, a dark forest looms.

>look
Grassy Slope
The meadow outside the hospital is peaceful and quiet. The sun, directly above, warms your face. 

A deep and raging river runs through to the south. Further, a dark forest looms.

>south
The river is far too wide and dangerous to cross on foot. Best to find another way. Continue anyway?

* * *

>east
Hospital Room (in the bed)
You are in what appears to be a hospital room. The walls are bare save for a bulletin board.

A cracked window lets in a feeble amount of light.

A door across the room is slightly ajar. Outside, voices drift softly back and forth.

You can also see a bulletin board here.

I beg your pardon?

>s
You would have to get out of the bed first.

* * *

>w
Riverbank
You arrive at a small peninsula in the riverbank. An unkempt woman sits on the porch of a small hut, absentmindedly tapping the ground beside her with a blackened fire poker.

A rickety bridge extends toward the opposite bank. It sways gently into the wind.

The woman's scratching forms a dreamlike rhythm...

>x woman
You see nothing special about a woman.

The woman's scratching forms a dreamlike rhythm...

>x hut
You can't see any such thing.

>ask woman
What do you want to ask a woman for?

>ask woman about the hut
There is no reply.

The woman's scratching forms a dreamlike rhythm...

>ask woman about the river
There is no reply.

The woman's scratching forms a dreamlike rhythm...

>ask woman about the bridge
There is no reply.

The woman's scratching forms a dreamlike rhythm...

>ask woman about bridge
The woman is willing to guide travelers across the river for a small fee - one dollar will do. 
The woman's scratching forms a dreamlike rhythm...

>give woman one dollar
You can't see any such thing.

>take dollar
You can't see any such thing.

>open wallet
You open the wallet, revealing one dollar and a Loungent Technologies ID card.

The woman's scratching forms a dreamlike rhythm...

>take dollar
Taken.

The woman's scratching forms a dreamlike rhythm...

>give woman dollar
The woman pockets the money and guides you across the bridge. As you cross she warns you against stepping on several of the bridge planks, which have led more than one traveler to their deaths. She laughs gutturally. Below you the river rages loudly.

dark forest
The forest hums with the chatter of animal life. The trees cast deep shadows across the undergrowth. Further to the south you see a faint orange electric glow.

A rickety bridge extends toward the opposite bank. It sways gently into the wind.

* * *

Southern Adventure
An Interactive Fiction by Sylvan Zheng
Release 1 / Serial number 201029 / Inform 7 build 6M62 (I6/v6.34 lib 6/12N) SD

Hospital Room (in the bed)
You are in what appears to be a hospital room. The walls are bare save for a bulletin board. 

A door across the room is slightly ajar. Outside, voices drift softly back and forth.

A cracked window lets in a feeble amount of light.

You see a phone, wallet, and keys on the table across the room.

You can also see a tattered novel here.

>take bed
That's fixed in place.

>x bed
It's a small bed.  The sheets are damp, perhaps more than you might expect from a normal amount of sweat.

* * *

Southern Adventure
An Interactive Fiction by Sylvan Zheng
Release 1 / Serial number 201029 / Inform 7 build 6M62 (I6/v6.34 lib 6/12N) SD

Hospital Room (in the bed)
You are in what appears to be a hospital room. The walls are bare save for a bulletin board. 

A door across the room is slightly ajar. Outside, voices drift softly back and forth.

A cracked window lets in a feeble amount of light.

You see a phone, wallet, and keys on the table across the room.

You can also see a tattered novel here.

>take w
You must name something more substantial.

>take wallet
Taken.

* * *

>gie
That's not a verb I recognise.

>give
(a woman the wallet)
The woman pockets the money and guides you across the bridge. As you cross she warns you against stepping on several of the bridge planks, which have led more than one traveler to their deaths. She laughs gutturally. Below you the river rages loudly.

dark forest
The forest hums with the chatter of animal life. The trees cast deep shadows across the undergrowth. Further in the distance you see a dim light, emnating an orange electric glow.

A rickety bridge extends toward the opposite bank. It sways gently into the wind.

>s
After pushing aside numerous branches and swatting away flies, you enter a clearing. In the clearing is a railroad station.

railroad station
The railroad station is impeccably architected, with a large archway entrance and beautiful iron grated windows

* * *

Southern Adventure
An Interactive Fiction by Sylvan Zheng
Release 1 / Serial number 201029 / Inform 7 build 6M62 (I6/v6.34 lib 6/12N) SD

Hospital Room (in the bed)
You are in what appears to be a hospital room. The walls are bare save for a bulletin board. 

A door across the room is slightly ajar. Outside, voices drift softly back and forth.

A cracked window lets in a feeble amount of light.

You see a phone, wallet, and keys on the table across the room.

You can also see a tattered novel here.

>take wallet
Taken.

* * *

>go w
You meander west along the riverbank for what seems like hours. Above you the sun barely moves in the sky, its rays continuing to illuminate your surroundings with a golden glow.

Riverbank
You see a hut in the distance

A rickety bridge extends toward the opposite bank. It sways gently into the wind.

An unkempt woman sits on the porch of the hut, fanning herself slowly with a folded newspaper.

>give wallet
(to a woman)
The woman pockets the money and guides you across the bridge. As you cross she warns you against stepping on several of the bridge planks, which have led more than one traveler to their deaths. She laughs gutturally.\n Below you the river rages loudly.

dark forest
A rickety bridge extends from the riverbank toward the opposite bank. It sways gently into the wind.

* * *

>go w
You meander west along the riverbank for what seems like hours. Above you the sun barely moves in the sky, its rays continuing to illuminate your surroundings with a golden glow.

Riverbank
You see a hut in the distance

A rickety bridge extends toward the opposite bank. It sways gently into the wind.

An unkempt woman sits on the porch of the hut, fanning herself slowly with a folded newspaper.

>go e
There's not much to see in that direction.

>give
(a woman the wallet)
The woman pockets the money and guides you across the bridge. As you cross she warns you against stepping on several of the bridge planks, which have led more than one traveler to their deaths. She laughs gutturally. Below you the river rages loudly.

dark forest
The forest hums with the chatter of animal life. The trees cast deep shadows across the undergrowth. Further in the distance you see a dim light, emnating an orange electric glow.

A rickety bridge extends toward the opposite bank. It sways gently into the wind.

>go s
After pushing aside numerous branches and swatting away flies, you enter a clearing. In the clearing is a railroad station.

railroad station
The railroad station is impeccably architected, with a large archway entrance and beautiful iron grated windows.

>go in
You can't go that way.

* * *

>go w
You meander west along the riverbank for what seems like hours. Above you the sun barely moves in the sky, its rays continuing to illuminate your surroundings with a golden glow.

Riverbank
You see a hut in the distance

A rickety bridge extends toward the opposite bank. It sways gently into the wind.

An unkempt woman sits on the porch of the hut, fanning herself slowly with a folded newspaper.

>go s
You gingerly take a few steps. The planks creak menacingly.
On the fourth step the bridge plank cracks beneath your feet! You plummet into the river.

Hospital Room
You are in what appears to be a hopsital room.

A cracked window lets in a feeble amount of light.

A door across the room is slightly ajar. Outside voices drift softly back and forth.

There is an IV drip next to you.

You are lying in a bed.

You see a phone on the table across the room.

You can also see keys, a sheaf of papers and a tattered novel here.

* * *

>go w
You meander west along the riverbank for what seems like hours. Above you the sun barely moves in the sky, its rays continuing to illuminate your surroundings with a golden glow.

Riverbank
You see a hut in the distance

A rickety bridge extends toward the opposite bank. It sways gently into the wind.

An unkempt woman sits on the porch of the hut, fanning herself slowly with a folded newspaper.

>give
(a woman the wallet)
The woman pockets the money and guides you across the bridge. As you cross she warns you against stepping on several of the bridge planks, which have led more than one traveler to their deaths. She laughs gutturally. Below you the river rages loudly.

dark forest
The forest hums with the chatter of animal life. The trees cast deep shadows across the undergrowth. Further to the south you see a faint orange electric glow.

A rickety bridge extends toward the opposite bank. It sways gently into the wind.

>go s
After pushing aside numerous branches and swatting away flies, you enter a clearing. In the clearing is a railroad station.

railroad station
The railroad station is impeccably architected, with a large archway entrance and beautiful iron grated windows.

A cat with a beautiful dark coat of fur purrs gently, asleep.

You can also see a ticket counter here.

>x ticket counter
The ticket counter seems deserted.

>go train
You can't see any such thing.

>go in
You can't go that way.

* * *

>w
You meander west along the riverbank for what seems like hours. Above you the sun barely moves in the sky, its rays continuing to illuminate your surroundings with a golden glow.

Riverbank
You see a hut in the distance

A rickety bridge extends toward the opposite bank. It sways gently into the wind.

An unkempt woman sits on the porch of the hut, fanning herself slowly with a folded newspaper.

>s
You gingerly take a few steps. The planks creak menacingly.
On the fourth step the bridge plank cracks beneath your feet! You plummet into the river.

Hospital Room
You are in what appears to be a hospital room. The walls are bare save for a bulletin board.

A cracked window lets in a feeble amount of light.

A door across the room is slightly ajar. Outside voices drift softly back and forth.

There is an IV drip next to you.

You are lying in a bed.

You see a phone on the table across the room.

You can also see keys, a bulletin board and a tattered novel here.

>s
Grassy Slope
The meadow is peaceful and quiet. The sun, directly ahead, warms your face. In the distance to the west you can make out a small shack.

A cracked window lets in a feeble amount of light.

A deep and raging river runs through the meadow to the south. Further, a dark forest looms.

* * *

>x ticket counter
The ticket counter seems deserted. However, there is a train waiting at the southern platform with its doors ajar.

>s
You can't go that way.

* * *

>go west
You meander west along the riverbank for what seems like hours. Above you the sun barely moves in the sky, its rays continuing to illuminate your surroundings with a golden glow.

Riverbank
You see a hut in the distance

A rickety bridge extends from the riverbank toward the opposite bank. It sways gently into the wind.

An unkempt woman sits on the porch of the hut, fanning herself slowly with a folded newspaper.

>go south
You gingerly take a few steps. The planks creak menacingly.
On the fourth step the bridge plank cracks beneath your feet! You plummet into the river.

Hospital Room
You are in what appears to be a hopsital room.

A cracked window lets in a feeble amount of light.

A door across the room is slightly ajar. Outside voices drift softly back and forth.

There is an IV drip next to you.

You are lying in a bed.

You see a phone on the table across the room.

You can also see keys, a sheaf of papers and a tattered novel here.

* * *

Southern Adventure
An Interactive Fiction by Sylvan Zheng
Release 1 / Serial number 201029 / Inform 7 build 6M62 (I6/v6.34 lib 6/12N) SD

Hospital Room (in the bed)
You are in what appears to be a hospital room. The walls are bare save for a bulletin board. 

A door across the room is slightly ajar. Outside, voices drift softly back and forth.

A cracked window lets in a feeble amount of light.

You see a phone, wallet, and keys on the table across the room.

You can also see a tattered novel here.

>use phone
That's not a verb I recognise.

* * *

Southern Adventure
An Interactive Fiction by Sylvan Zheng
Release 1 / Serial number 201029 / Inform 7 build 6M62 (I6/v6.34 lib 6/12N) SD

Hospital Room (in the bed)
You are in what appears to be a hospital room. The walls are bare save for a bulletin board. 

A door across the room is slightly ajar. Outside, voices drift softly back and forth.

A cracked window lets in a feeble amount of light.

You see a phone, wallet, and keys on the table across the room.

You can also see a tattered novel here.

>use the phone
Nothing is written on the phone.

>x phone
There are no unread messages.

* * *

Southern Adventure
An Interactive Fiction by Sylvan Zheng
Release 1 / Serial number 201029 / Inform 7 build 6M62 (I6/v6.34 lib 6/12N) SD

Hospital Room (in the bed)
You are in what appears to be a hospital room. The walls are bare save for a bulletin board. 

A door across the room is slightly ajar. Outside, voices drift softly back and forth.

A cracked window lets in a feeble amount of light.

You see a phone, wallet, and keys on the table across the room.

You can also see a tattered novel here.

>x bed
It's a small bed.  The over-starched sheets are slightly uncomfortable.

>take bed
Taken.

* * *

Southern Adventure
An Interactive Fiction by Sylvan Zheng
Release 1 / Serial number 201029 / Inform 7 build 6M62 (I6/v6.34 lib 6/12N) SD

Hospital Room (in the bed)
You are in what appears to be a hospital room. The walls are bare save for a bulletin board. 

A door across the room is slightly ajar. Outside, voices drift softly back and forth.

A cracked window lets in a feeble amount of light.

You see a phone, wallet, and keys on the table across the room.

You can also see a tattered novel here.

>x bulletin board
A sheaf of medical papers suggest that the patient's sepsis complication has reached a critical stage. The next page seems to be an authorization to begin end-of-life care proceedings, signed by the patient's next of kin, their sister. It's difficult to read the small print, so you quickly give up and put the papers down.

* * *

Southern Adventure
An Interactive Fiction by Sylvan Zheng
Release 1 / Serial number 201029 / Inform 7 build 6M62 (I6/v6.34 lib 6/12N) SD

Hospital Room (in the bed)
You are in what appears to be a hospital room. The walls are bare save for a bulletin board. 

A door across the room is slightly ajar. Outside, voices drift softly back and forth.

A cracked window lets in a feeble amount of light.

You see a phone, wallet, and keys on the table across the room.

You can also see a tattered novel here.

>x cat
You can't see any such thing.

* * *

Southern Adventure
An Interactive Fiction by Sylvan Zheng
Release 1 / Serial number 201029 / Inform 7 build 6M62 (I6/v6.34 lib 6/12N) SD

Hospital Room (in the bed)
You are in what appears to be a hospital room. The walls are bare save for a bulletin board. 

A door across the room is slightly ajar. Outside, voices drift softly back and forth.

A cracked window lets in a feeble amount of light.

You see a phone, wallet, and keys on the table across the room.

You can also see a tattered novel here.

>x corners
You can't see any such thing.

* * *

Southern Adventure
An Interactive Fiction by Sylvan Zheng
Release 1 / Serial number 201029 / Inform 7 build 6M62 (I6/v6.34 lib 6/12N) SD

Hospital Room (in the bed)
You are in what appears to be a hospital room. The walls are bare save for a bulletin board. 

A door across the room is slightly ajar. Outside, voices drift softly back and forth.

A cracked window lets in a feeble amount of light.

You see a phone, wallet, and keys on the table across the room.

You can also see a tattered novel here.

>x iv drip
It's a bag of fluid raised above you. A small tube runs from the bag into your arm.

>x bed
It's a small bed. The over-starched sheets are slightly uncomfortable.

>go north
You can't go that way.

* * *

Southern Adventure
An Interactive Fiction by Sylvan Zheng
Release 1 / Serial number 201029 / Inform 7 build 6M62 (I6/v6.34 lib 6/12N) SD

Hospital Room (in the bed)
You are in what appears to be a hospital room. The walls are bare save for a bulletin board. 

A door across the room is slightly ajar. Outside, voices drift softly back and forth.

A cracked window lets in a feeble amount of light.

You see a phone, wallet, and keys on the table across the room.

You can also see a tattered novel here.

>x novel
It's a dog eared copy of Don Quixote, by Migeul Cervantes.

>x wallet
The wallet contains a few dollars and a Loungent Technologies ID card

* * *

Southern Adventure
An Interactive Fiction by Sylvan Zheng
Release 1 / Serial number 201029 / Inform 7 build 6M62 (I6/v6.34 lib 6/12N) SD

Hospital Room (in the bed)
You are in what appears to be a hospital room. The walls are bare save for a bulletin board. 

A door across the room is slightly ajar. Outside, voices drift softly back and forth.

A cracked window lets in a feeble amount of light.

You see a phone, wallet, and keys on the table across the room.

You can also see a tattered novel here.

>x phone
There are no unread messages.

>take everything
phone: Taken.
wallet: Taken.
keys: Taken.
tattered novel: Taken.

>x novel
It's a dog eared copy of Don Quixote, by Miguel Cervantes.

>x bulletin board
A page pinned to the board suggests that the patient's sepsis complication has reached a critical stage. The next page seems to be an authorization to begin end-of-life care proceedings, signed by the patient's next of kin, their sister. It's difficult to read the small print, so you quickly give up and put the papers down.

>kill self
Violence isn't the answer to this one.

>x window
Through the window you make out a grassy meadow cut by a deep and raging river. Beyond it lies a forest.

>x door
You see nothing special about the hall door.

>n
You would have to get out of the bed first.

>get out of bed
I only understood you as far as wanting to get outside.

>get out
You get out of the bed.

Hospital Room
You are in what appears to be a hospital room. The walls are bare save for a bulletin board.

A door across the room is slightly ajar. Outside, voices drift softly back and forth.

A cracked window lets in a feeble amount of light.

You are lying in a bed.

You can also see a bulletin board here.

>leave
But you aren't in anything at the moment.

>w
You can't go that way.

>e
You can't move very far while attached to the IV drip.

>unattach iv drip
That's not a verb I recognise.

>remove iv drip
You yank out the IV drip from your arm.

>ouch
That's not a verb I recognise.

>e
The hallway is full of hospital staff, bustling to and fro. Eventually, one notices your hospital gown and ushers you back into your room.

Hospital Room
You are in what appears to be a hospital room. The walls are bare save for a bulletin board.

A door across the room is slightly ajar. Outside, voices drift softly back and forth.

A cracked window lets in a feeble amount of light.

You are lying in a bed.

You can also see a bulletin board here.

Hospital Room (in the bed)
You are in what appears to be a hospital room. The walls are bare save for a bulletin board.

A door across the room is slightly ajar. Outside, voices drift softly back and forth.

A cracked window lets in a feeble amount of light.

You can also see a bulletin board here.

>e
You would have to get out of the bed first.

>get out
You get out of the bed.

Hospital Room
You are in what appears to be a hospital room. The walls are bare save for a bulletin board.

A door across the room is slightly ajar. Outside, voices drift softly back and forth.

A cracked window lets in a feeble amount of light.

You are lying in a bed.

You can also see a bulletin board here.

>s
The window is shut: you'd break the glass.

>break the glass
You can't see any such thing.

>n
You can't go that way.

>w
You can't go that way.

* * *

>remove iv drip
You yank out the IV drip from your arm.

>e
The hallway is full of hospital staff, bustling to and fro. Eventually, one notices your hospital gown and ushers you back into your room.

Hospital Room
You are in what appears to be a hospital room. The walls are bare save for a bulletin board.

A door across the room is slightly ajar. Outside, voices drift softly back and forth.

A cracked window lets in a feeble amount of light.

You are lying in a bed.

You can also see a bulletin board here.

Hospital Room (in the bed)
You are in what appears to be a hospital room. The walls are bare save for a bulletin board.

A door across the room is slightly ajar. Outside, voices drift softly back and forth.

A cracked window lets in a feeble amount of light.

You can also see a bulletin board here.

>get out
You get out of the bed.

Hospital Room
You are in what appears to be a hospital room. The walls are bare save for a bulletin board.

A door across the room is slightly ajar. Outside, voices drift softly back and forth.

A cracked window lets in a feeble amount of light.

You are lying in a bed.

You can also see a bulletin board here.

>w
You can't go that way.

>w
You can't go that way.

I beg your pardon?

I beg your pardon?

>n
You can't go that way.

>s
The window is shut: you'd break the glass.

>open window
You open the cracked window.

>s
You can't move very far while attached to the IV drip.

* * *

>remove iv drip
You yank out the IV drip from your arm.

>s
Grassy Slope
The meadow is peaceful and quiet. The sun, directly ahead, warms your face. In the distance to the west you can make out a small shack.

A cracked window lets in a feeble amount of light.

A deep and raging river runs through the meadow to the south. Further, a dark forest looms.

>s
The river is far too wide and dangerous to cross on foot. Best to find another way.

>w
You meander west along the riverbank for what seems like hours. Above you the sun barely moves in the sky, its rays continuing to illuminate your surroundings with a golden glow.

Riverbank
You see a hut in the distance

A rickety bridge extends toward the opposite bank. It sways gently into the wind.

An unkempt woman sits on the porch of the hut, fanning herself slowly with a folded newspaper.

>x woman
You see nothing special about a woman.

>talk to woman
To start a conversation, try to ASK a woman ABOUT something.

>hey lady
That's not a verb I recognise.

>ask woman about hut
The woman is willing to guide travelers across the river for a small fee - one dollar will do.

>pay the woman
What do you want to pay a woman?

>one dollar
You can't see any such thing.

>x wallet
The wallet contains a few dollars and a Loungent Technologies ID card.

>remove dollars
You can't see any such thing.

>give woman wallet
The woman pockets the money and guides you across the bridge. As you cross she warns you against stepping on several of the bridge planks, which have led more than one traveler to their deaths. She laughs gutturally. Below you the river rages loudly.

dark forest
The forest hums with the chatter of animal life. The trees cast deep shadows across the undergrowth. Further to the south you see a faint orange electric glow.

A rickety bridge extends toward the opposite bank. It sways gently into the wind.

>n
The forest extends deeply in all directions

>s
After pushing aside numerous branches and swatting away flies, you enter a clearing. In the clearing is a railroad station.

railroad station
The railroad station is impeccably architected, with a large archway entrance and beautiful iron grated windows.

A cat with a beautiful dark coat of fur purrs gently, curled up on the tiled floor.

You can also see a ticket counter here.

>x cat
You see nothing special about the black cat.

>kill cat
Violence isn't the answer to this one.

>adopt cat
That's not a verb I recognise.

>pet cat
You stroke the cat absentmindedly.

>x ticket counter
The ticket counter seems deserted. However, there is a train waiting at the southern platform with its doors ajar.

>board train
That's not a verb I recognise.

>enter train
You can't see any such thing.

>s
traincar
You board the train. The conductor walks by, and instead of checking for your ticket merely gives you a friendly smile. You sit down in an empty compartment, which isn't particularly difficult to find. Unperturbed, you settle into your seat as the train clunks into motion.

Looking out the window you see the forest give way to valleys and mountains, and then open plains with the occasional solitary cow. The sun, still yellow in the sky gives clouds a luminance that makes them like appear like marble. The shadow of the railroad car stretches longer and longer toward the horizon, yet the sun remains fixed in the sky, at that golden angle just before dusk. From your seat on the train the country appears both vast and intimate.

You can also see a train door here.

>x window
It's an ordinary train window. Beyond it though lies the changing scenery of the countryside, fields and trees somewhat unfamiliar to you.

>s
It would be wise to wait until the train is stopped before attempting to get off!

>n
railroad station
The railroad station is impeccably architected, with a large archway entrance and beautiful iron grated windows.

A cat with a beautiful dark coat of fur purrs gently, curled up on the tiled floor.

You can also see a ticket counter here.

>s
traincar
You board the train. The conductor walks by, and instead of checking for your ticket merely gives you a friendly smile. You sit down in an empty compartment, which isn't particularly difficult to find. Unperturbed, you settle into your seat as the train clunks into motion.

Looking out the window you see the forest give way to valleys and mountains, and then open plains with the occasional solitary cow. The sun, still yellow in the sky gives clouds a luminance that makes them like appear like marble. The shadow of the railroad car stretches longer and longer toward the horizon, yet the sun remains fixed in the sky, at that golden angle just before dusk. From your seat on the train the country appears both vast and intimate.

You can also see a train door here.

>e
You can't go that way.

>w
You can't go that way.

>door
That's not a verb I recognise.

>x door
You see nothing special about the train door.

>go to door
You can't see any such thing.

>i
You are carrying:
  a tattered novel
  keys
  a phone

>use phone
That's not a verb I recognise.

>read novel
You read: "It seems to me," responded don Quixote, "that you aren't well-versed in adventures-they are giants; and if you're afraid, get away from here and start praying while I go into fierce and unequal battle with them." 
 And saying this, he spurred his horse Rocinante without heeding what his squire Sancho was shouting to him, that he was attacking windmills and not giants. But he was so certain they were giants that he paid no attention to his squire Sancho's shouts, nor did he see what they were, even though he was very close. Rather, he went on shouting: "Do not flee, cowards and vile creatures, for it's just one knight attacking you!"

A grinding screech jolts you out of Cervantes" intricate world. Looking out the window it seems the train has stopped. The conductor has reappeared and has opened the train door.

>s
You trek for a half mile along the train tracks, the yellow sun continuing to illuminate the great grassy plain around you with a golden aura.

town square
You are in a sleepy town square. You can see a saloon to the west and a shuttered general store to the east.

A large crowd is gathered in the square. You can't quite make out what they're saying, but they seem moderately upset.

You can also see a train door here.

town square
You are in a sleepy town square. You can see a saloon to the west and a shuttered general store to the east.

A large crowd is gathered in the square. You can't quite make out what they're saying, but they seem moderately upset.

You can also see a train door here.

>w
saloon
An empty saloon.

Your nurse from the hospital is absentmindedly drying glasses behind the bar. You blink. The bartender looks up at you quizzically and you realize you certainly made a mistake.

>talk to baratender
You can't see any such thing.

>talk to bartender
To start a conversation, try to ASK the bartender ABOUT something.

>ask the bartender about the town
Unfortunately the taxi drivers are out on strike today. You might have seen them out in the square. If you're not in a rush, it might be a good idea to stay in town for the night. Would you care for a drink?

>sure
Please answer yes or no.

>yes
The bartender pours you a Sazerac, the deep orange of the rye whiskey casting a faint glow on the dusty table. Certainly you haven't had one of these in a while - the hospital's bar service was rather lacking due to its nonexistence.

>ask the bartender about the hospital
Unfortunately the taxi drivers are out on strike today. You might have seen them out in the square. If you're not in a rush, it might be a good idea to stay in town for the night. Would you care for a drink?

>yes
The bartender pours you a Sazerac, the deep orange of the rye whiskey casting a faint glow on the dusty table. Certainly you haven't had one of these in a while - the hospital's bar service was rather lacking due to its nonexistence.

>drink sazerac
You can't see any such thing.

>e
town square
You are in a sleepy town square. You can see a saloon to the west and a shuttered general store to the east.

A large crowd is gathered in the square. You can't quite make out what they're saying, but they seem moderately upset.

You can also see a train door here.

>x crowd
You see nothing special about Crowd.

>e
The general store is closed, which seems odd for this time of day. Perhaps that's just the way they do things out in the countryside.

>e
The general store is closed, which seems odd for this time of day. Perhaps that's just the way they do things out in the countryside.

>w
saloon
An empty saloon.

Your nurse from the hospital is absentmindedly drying glasses behind the bar. You blink. The bartender looks up at you quizzically and you realize you certainly made a mistake.

>e
town square
You are in a sleepy town square. You can see a saloon to the west and a shuttered general store to the east.

A large crowd is gathered in the square. You can't quite make out what they're saying, but they seem moderately upset.

You can also see a train door here.

>s
You can't go that way.

>n
traincar
You board the train. The conductor walks by, and instead of checking for your ticket merely gives you a friendly smile. You sit down in an empty compartment, which isn't particularly difficult to find. Unperturbed, you settle into your seat as the train clunks into motion.

Looking out the window you see the forest give way to valleys and mountains, and then open plains with the occasional solitary cow. The sun, still yellow in the sky gives clouds a luminance that makes them like appear like marble. The shadow of the railroad car stretches longer and longer toward the horizon, yet the sun remains fixed in the sky, at that golden angle just before dusk. From your seat on the train the country appears both vast and intimate.

You can also see a train door and a conductor here.

>talk to crowd
You can't see any such thing.

>n
railroad station
The railroad station is impeccably architected, with a large archway entrance and beautiful iron grated windows.

A cat with a beautiful dark coat of fur purrs gently, curled up on the tiled floor.

You can also see a ticket counter here.

>s
traincar
You board the train. The conductor walks by, and instead of checking for your ticket merely gives you a friendly smile. You sit down in an empty compartment, which isn't particularly difficult to find. Unperturbed, you settle into your seat as the train clunks into motion.

Looking out the window you see the forest give way to valleys and mountains, and then open plains with the occasional solitary cow. The sun, still yellow in the sky gives clouds a luminance that makes them like appear like marble. The shadow of the railroad car stretches longer and longer toward the horizon, yet the sun remains fixed in the sky, at that golden angle just before dusk. From your seat on the train the country appears both vast and intimate.

You can also see a train door and a conductor here.

>s
You trek for a half mile along the train tracks, the yellow sun continuing to illuminate the great grassy plain around you with a golden aura.

town square
You are in a sleepy town square. You can see a saloon to the west and a shuttered general store to the east.

A large crowd is gathered in the square. You can't quite make out what they're saying, but they seem moderately upset.

You can also see a train door here.

town square
You are in a sleepy town square. You can see a saloon to the west and a shuttered general store to the east.

A large crowd is gathered in the square. You can't quite make out what they're saying, but they seem moderately upset.

You can also see a train door here.

>talk to crowd
To start a conversation, try to ASK Crowd ABOUT something.

>ask crowd about taxis
You pull someone out of the crowd to ask about Crowd
Angry, they push you away derisively, and you stumble backward, stepping onto someone's toe behind you. Somewhat dazed, you realize the crowd's jeers are now directed at you, taunting and insulting. But how did they learn your name? A man is standing in front of you, gesticulating violently. He pulls out a knife with a snarl, twirling it menacingly around his fingers
Out of the corner of your eye an object flies through the air and lands at your feet. It's a naked dagger. Take it?

>take
Please answer yes or no.

>yes
Although you have never been in a fist fight before, let alone used a knife for anything besides cutting onions, you figure it would serve you better than your bare hands. Despite the train conductor's protestations you pick up the dagger.
The cold steel feels almost hot beneath your fingers.

    *** The End ***

Would you like to RESTART, RESTORE a saved game, QUIT or UNDO the last command?

* * *

Southern Adventure
An Interactive Fiction by Sylvan Zheng
Release 1 / Serial number 201029 / Inform 7 build 6M62 (I6/v6.34 lib 6/12N) SD

Hospital Room (in the bed)
You are in what appears to be a hospital room. The walls are bare save for a bulletin board. 

A door across the room is slightly ajar. Outside, voices drift softly back and forth.

A cracked window lets in a feeble amount of light.

You see a phone, wallet, and keys on the table across the room.

You can also see a tattered novel here.

>x puddle
You can't see any such thing

>take all
keys: Taken.
phone: Taken.
wallet: Taken.
tattered novel: Taken.

* * *

Southern Adventure
An Interactive Fiction by Sylvan Zheng
Release 1 / Serial number 201029 / Inform 7 build 6M62 (I6/v6.34 lib 6/12N) SD

Hospital Room (in the bed)
You are in what appears to be a hospital room. The walls are bare save for a bulletin board. 

A door across the room is slightly ajar. Outside, voices drift softly back and forth.

A cracked window lets in a feeble amount of light.

You see a phone, wallet, and keys on the table across the room.

You can also see a tattered novel here.

>x wallet
A simple brown leather wallet

>open wallet
You open the wallet, revealing one dollar and a Loungent Technologies ID card.

>i
You are carrying nothing.

>x wallet
A simple brown leather wallet

In the wallet are one dollar and a Loungent Technologies ID card.

* * *

>open wallet
You open the wallet, revealing one dollar and a Loungent Technologies ID card.

>take dollar
Taken.

>i
You are carrying:
  one dollar

* * *

>x wallet
A simple brown leather wallet

>take dollar
Taken.

>x wallet
A simple brown leather wallet

In the wallet is a Loungent Technologies ID card.

>take wallet
Taken.

>remove iv drip
You yank out the IV drip from your arm.

* * *

>open window
You open the cracked window.

>go s
Grassy Slope
The meadow is peaceful and quiet. The sun, directly ahead, warms your face. In the distance to the west you can make out a small hut.

A deep and raging river runs through to the south. Further, a dark forest looms.

>i
You are carrying:
  a wallet (open)
    a Loungent Technologies ID card
  one dollar

>take id card
Taken.

* * *

>x wallet
A simple brown leather wallet

>x iv drip
It's a bag of fluid raised above you. A small tube runs from the bag into your arm.

>x phone
There are no unread messages.

* * *

>x wallet
A simple brown leather wallet

>x keys
You see nothing special about Keys.

>x phone
You see nothing special about the phone.

>x bed
You see nothing special about the bed.

>x iv drip
You see nothing special about the IV drip.

* * *

Southern Adventure
An Interactive Fiction by Sylvan Zheng
Release 1 / Serial number 201029 / Inform 7 build 6M62 (I6/v6.34 lib 6/12N) SD

Hospital Room (in the bed)
You are in what appears to be a hospital room. The walls are bare save for a bulletin board. 

A door across the room is slightly ajar. Outside, voices drift softly back and forth.

A cracked window lets in a feeble amount of light.

You see a phone, wallet, and keys on the table across the room.

You can also see a tattered novel here.

>x window
Through the window you make out the grassy slope

>climb through window
You can't see any such thing.

>go east
You can't go that way.

>search window
You can't see any such thing.

* * *

>x window
Through the window you make out the grassy slope

>go east
You can't go that way.

>open window
You can't see any such thing.

>x window
You can't see any such thing.

>search window
You can't see any such thing.

* * *

>x window
Through the window you make out the grassy slope

>search window
Through the window you make out the Grassy Slope